aa: aa
abb: abb
abnormal: abnormal
absence: absence
abstract: abstract
access: access
accuracy: accuracy
ache: ache
act: act
action: action
activity: activity
ad: ad
add: add
address: address
administer: administer
adult: adult
advantage: advantage
ae: ae
aer: aer
affect: affect
affected: affected
aid: aid
aim: aim
ait: ait
alert: alert
along: along
also: also
alteration: alteration
ami: ami
anal: anal
analogous: analogous
anatomy: anatomy
ani: ani
antiepileptic: antiepileptic
anus: anus
ape: ape
appropriate: appropriate
archive: archive
area: area
arm: arm
artery: artery
article: article
assessment: assessment
assist: assist
associate: associated
atraumatic: atraumatic
attend: attend
attribution: attribution
baby: baby
basis: basis
become: become
beside: beside
best: best
birth: birth
block: blocking
blood: blood
board: board
botulinum: botulinum
burning: burning
bus: bus
capable: capable
car: car
cardinal: cardinal
careful: careful
carefully: carefully
case: case
cause: cause
ce: ce
child: child
chronic: chronic
cite: cite
clarify: clarify
clear: clear
clinic: clinic
clinical: clinical
combination: combination
common: common commons
complaint: complaint
completely: completely
complication: complication
conclusion: conclusion
condition: condition
conduction: conduction
confirm: confirm confirmed
consent: consent
consider: considered
constant: constant
consultant: consultant
contact: contact
continence: continence
conventional: conventional
copyright: copyright
could: could
course: course
creative: creative
critical: critical
current: current
customer: customer
cycling: cycling
cyclist: cyclist
cystitis: cystitis
data: data
day: days
decade: decade
decide: decided
declare: declare
defecation: defecation
denervation: denervation
design: designed
detection: detection
determine: determined
diagnosis: diagnosis
different: different
direct: direct
directly: directly
disclaimer: disclaimer
discomfort: discomfort
discussion: discussion
disposable: disposable
disruption: disruption
distal: distal
distressed: distressed
divide: divided
dose: dose
dresser: dresser
due: due
duration: duration
dysfunction: dysfunction
edition: edition
editorial: editorial
effect: effect effects
electrode: electrode
elevate: elevated
elimination: elimination
embarrassment: embarrassment
entrapment: entrapment
essential: essential
ethic: ethics
evaluation: evaluation
ever: ever
every: every
evidence: evidence
experienced: experienced
external: external
facial: facial
fail: fail
file: file
final: final
first: first
floor: floor
focus: focus
follow: follow
foramen: foramen
form: formed
found: found
four: four
free: free
frequent: frequent
frequently: frequently
full: full
function: function
genitourinary: genitourinary
get: get
give: give
great: greater
guidance: guidance
guideline: guideline
gynecology: gynecology
haemorrhoidal: haemorrhoidal
hair: hair
half: half
head: head
headache: headache
health: health
help: help
hence: hence
highlight: highlight
history: history
home: home
hospital: hospital
however: however
husband: husband
hypodermic: hypodermic
hysterectomy: hysterectomy
identify: identify
improve: improve
improvement: improvement
include: include included
incontinence: incontinence
index: indexing
inform: informed
information: information
initial: initial
initially: initially
injection: injection
injured: injured
injury: injury
input: input
insertional: insertional
integral: integral
intensity: intensity
interest: interest
international: international
interstitial: interstitial
intimate: intimate
introduction: introduction
ischial: ischial
isolation: isolation
issue: issue
joint: joint
journal: journal
journey: journey
junction: junction
know: known
labour: labour
last: last
latency: latency
later: later
lateral: lateral
left: left
length: length
lesser: lesser
levator: levator
level: level
library: library
license: license licensed
life: life
ligament: ligament
like: like
limited: limited
little: little
location: location
lock: lock
login: login
long: long
low: low
main: main
mainstay: mainstay
majority: majority
make: made
manuscript: manuscript
many: many
maternity: maternity
may: may
mechanism: mechanism
medication: medication
medicine: medicine
meeting: meeting
menu: menu
methodology: methodology
mi: mi
migraine: migraine
mild: mild
mile: mile
million: million
modality: modality
montage: montage
motor: motor
much: much
muscle: muscle
national: national
nature: nature
necessary: necessary
needle: needle
negative: negative
nerve: nerve
nettle: nettle
neuralgia: neuralgia
neuropathic: neuropathic
neuropathy: neuropathy
neurophysiological: neurophysiological
neurophysiology: neurophysiology
new: new
news: news
normal: normal
number: number
numbness: numbness
obstetrics: obstetrics
occur: occur
often: often
ongoing: ongoing
onset: onset
open: open
option: option
oral: oral
outcome: outcome
outline: outlined
pain: pain
painful: painful
paper: paper
passenger: passenger
past: past
pathology: pathology
patient: patient
pattern: pattern
pay: pay
pelvic: pelvic
pelvis: pelvis
perhaps: perhaps
perineal: perineal
perineum: perineum
period: period
peripheral: peripheral
persist: persisting
placement: placement
plexus: plexus
point: point
policy: policy
polio: polio
popular: popular
positive: positive
posterior: posterior
potential: potential
predominantly: predominantly
presence: presence
presentation: presentation
preservation: preservation
pressure: pressure
prevention: prevention
previously: previously
price: price
privacy: privacy
problem: problem
procedure: procedure
proofread: proofreading
protocol: protocol
proven: proven
pst: pst
psych: psych
publication: publication
pudendal: pudendal
quality: quality
quantify: quantify
quantitative: quantitative
quickly: quickly
quite: quite
rapid: rapid
rather: rather
reasonable: reasonable
receive: receive
recommend: recommend
record: recording
recovery: recovery
recruitment: recruitment
reduce: reduce reducing
reduction: reduction
reflex: reflex
regularly: regularly
related: related
relatively: relatively
release: release
relieve: relieving
remotely: remotely
reoccur: reoccur
repeat: repeat repeated
report: report
research: research
reserve: reserved
resistant: resistant
resolve: resolve
response: response
result: result
retraction: retraction
return: return
right: right
risk: risk
sacral: sacral
sacrospinous: sacrospinous
sacrotuberous: sacrotuberous
saddle: saddle
sar: sar
sciatic: sciatic
scientific: scientific
scope: scope
seek: seeking
select: select
sensory: sensory
service: service
severe: severe
sexual: sexual
shame: shame
share: share
side: side sides
significant: significant
significantly: significantly
similar: similar
simply: simply
single: single
sit: sitting
site: site
small: small
social: social
society: society
soft: soft
spasm: spasm
spasmodic: spasmodic
special: special
specific: specific
sphincter: sphincter
spine: spine
sport: sports
square: square
stab: stabbing
stage: stage
stand: stand
statement: statement
stimulation: stimulation
sting: sting
structure: structure
subject: subject
submit: submit
subscription: subscription
subsequent: subsequent
successful: successful
successfully: successfully
suffer: suffer
suggest: suggesting
supply: supply
sustain: sustained
symptom: symptom
syndrome: syndrome
system: system
take: taken
teca: teca
terminal: terminal
therapeutic: therapeutic
therapy: therapy
therefore: therefore
thought: thought
threshold: threshold
ti: ti
tibial: tibial
time: time times
tingle: tingling
toll: toll
top: top
toxin: toxin
translation: translation
travel: travel travelled
treat: treat
treatment: treatment
trial: trial
trigger: trigger
try: try
tucker: tucker
type: type
unable: unable
understood: understood
unit: unit
unlike: unlike
unspoken: unspoken
upwards: upwards
urinary: urinary
urination: urination
urogenital: urogenital
urology: urology
us: us
use: use used
usually: usually
uterine: uterine
vagina: vagina
vaginal: vaginal
vascular: vascular
vault: vault
veracity: veracity
view: view
volume: volume
vulnerable: vulnerable
vulvar: vulvar
way: way
weaken: weaken
well: well
wet: wet
willing: willing
wise: wise
without: without
woman: woman
work: work
world: world
year: year
ym: ym
