aa: aa
abb: abb
absence: absence
abstract: abstract
access: access
accomplish: accomplish
accord: according
accordance: accordance
acquire: acquired
acquisition: acquisition
act: act
action: action
activation: activation
activity: activity
ad: ad
add: add added
addition: addition
additional: additional
address: address
ae: ae
aer: aer
affected: affected
afterwards: afterwards
age: aged
agreement: agreement
ahead: ahead
aid: aid
aim: aim
ait: ait
al: al
ale: ale
alert: alert
already: already
also: also
alter: alter
alternate: alternating
alternately: alternately
always: always
ami: ami
among: among
amongst: amongst
amount: amount
analysis: analysis
anatomic: anatomic
anatomical: anatomical
anes: anes
annals: annals
announcement: announcement
another: another
anterior: anterior
ape: ape
apply: applied
approach: approach
approximately: approximately
architecture: architecture
archive: archive
area: area
arm: arms
article: article
assess: assess
associate: associated
asymmetry: asymmetry
atlas: atlas
attach: attached
attentional: attentional
attribution: attribution
available: available
average: average
avoid: avoid
bank: bank
bar: bar
barbas: barbas
basal: basal
base: based
behavior: behavior
behavioral: behavioral
best: best
beyond: beyond
bilateral: bilateral
bilaterally: bilaterally
bimanual: bimanual
binder: binder
binomial: binomial
blood: blood
board: board
body: body
brain: brain
brass: brass
brazil: brazil
bulletin: bulletin
calculate: calculated
carry: carried
case: case
categorical: categorical
catholic: catholic
caudal: caudal
cause: cause
ce: ce
center: center
central: central
cerebral: cerebral
chang: chang
change: change
chapman: chapman
characteristic: characteristic
chart: chart
cingulate: cingulate
cingulated: cingulated
cite: cite
classify: classified
claustrophobia: claustrophobia
clinical: clinical
cognitive: cognitive
coil: coil
collaboration: collaboration
combine: combining
commissure: commissure
committee: committee
common: commons
comparative: comparative
compare: compare
comparison: comparison
complex: complex
complexity: complexity
computer: computer
conclusion: conclusion
consensus: consensus
consent: consent
consequently: consequently
consider: considered considering
consistent: consistent
contact: contact
continuous: continuous
contralateral: contralateral
contrary: contrary
contribute: contribute
control: control
convenient: convenient
convention: convention
coplanar: coplanar
copyright: copyright
cornu: cornu
cortex: cortex cortices
cortical: cortical
corticospinal: corticospinal
could: could
creative: creative
criterion: criteria
cross: crossing
crucial: crucial
current: current
customer: customer
da: das
data: data
decide: decided
declare: declare
decrease: decrease
define: defined
degree: degree
delineation: delineation
demonstrate: demonstrate
depend: depend depending
depth: depth
design: designed designing
despite: despite
detection: detection
determinant: determinant
determine: determine determined
development: development
deviation: deviation
device: device
diagnostic: diagnostic
differ: differ
difference: difference
different: different
difficult: difficult
difficulty: difficulty
direct: directed
directly: directly
disclaimer: disclaimer
discussion: discussion
disorder: disorder
dispersion: dispersion
dissociation: dissociation
distribution: distribution
dominance: dominance
dominant: dominant
dong: dong
dorsal: dorsal
dorsolateral: dorsolateral
dum: dum
duration: duration
e: es
echo: echo
editorial: editorial
education: education
effect: effect effects
effort: effort
either: either
elaboration: elaboration
electrical: electrical
eleven: eleven
end: end
entire: entire
entirely: entirely
epidemiological: epidemiological
equally: equally
equation: equation
equivalent: equivalent
error: error
especially: especially
establish: established
ethic: ethics
evaluation: evaluation
event: event
every: every
evidence: evidence
exact: exact
exam: exam
examination: examination
examine: examining
examiner: examiner
example: example
excel: excel
except: except
excess: excess
exclude: exclude
exclusion: exclusion
execute: executed
execution: execution
exhibit: exhibit
expansive: expansive
expect: expect
experiment: experiment
experimental: experimental
explain: explain
explanation: explanation
extend: extending
external: external
externally: externally
extract: extracted
facilitate: facilitate
fact: fact
factor: factor
far: far
favor: favor
figure: figure
file: file
finger: finger
first: first
fisher: fisher
five: five
flow: flow
follow: follow following
form: formed
found: found
four: four
free: free
frequently: frequently
frontal: frontal
fry: fried
function: function
functional: functional
ganglion: ganglia
gender: gender
genu: genu
give: gave given
graph: graph
graphic: graphics
gray: gray
great: greater
grey: grey
group: group
guideline: guideline
hall: hall
han: han
hand: hand
handedness: handedness
hander: hander
head: head
health: health
healthy: healthy
hearing: hearing
hemisphere: hemisphere
hemispherical: hemispherical
hertz: hertz
high: high higher highest
history: history
home: home
honda: honda
horn: horn
hospital: hospital
hot: hot
however: however
human: human
hypothesis: hypothesis
idea: idea
image: image
impact: impact
impairment: impairment
important: important
include: include included
increase: increase increasing
independent: independent
independently: independently
index: index indexing
indicate: indicate
individual: individual
induced: induced
influence: influence
inform: informed
ing: ing
initiation: initiation
inscription: inscription
insert: inserted
instead: instead
institute: institute
instruct: instructed
intend: intending
intensity: intensity
intentional: intentional
interest: interest
internal: internal
internally: internally
international: international
interpret: interpret
interrupt: interrupted
intersection: intersection
interval: interval
introduction: introduction
invariably: invariably
inventory: inventory
investigate: investigate
involve: involved
involvement: involvement
ipsilateral: ipsilateral
issue: issue
join: join
journal: journal
kim: kim
kraft: kraft
laird: laird
language: language
later: later
laterality: laterality
lateralization: lateralization
learn: learned learning
lee: lee
left: left
lesion: lesion
less: less
level: level
lewis: lewis
library: library
license: license licensed
lie: lie
light: light
limit: limit
limited: limited
line: line
linear: linear
literature: literature
little: little
lobe: lobe
location: location
login: login
look: look
low: lower
magnetic: magnetic
magneton: magneton
magnitude: magnitude
mainly: mainly
majority: majority
make: made
malformation: malformation
man: man
manual: manual
manuscript: manuscript
many: many
marked: marked
matter: matter
maximum: maximum
may: may
mean: mean
measurement: measurement
medial: medial
medical: medical
medicine: medicine
memory: memory
menu: menu
meta: meta
metal: metal
mi: mi
might: might
minimal: minimal
mirror: mirror
monkey: monkey
moreover: moreover
morris: morris
motor: motor
move: move
movement: movement
multiple: multiple
nature: nature
necessary: necessary
need: needs
negative: negative
nervous: nervous
neural: neural
neurological: neurological
neurology: neurology
neuronal: neuronal
neurophysiology: neurophysiology
neutrality: neutrality
new: new
news: news
newspaper: newspaper
normal: normal
north: north
notably: notably
number: number
obtain: obtain
occasionally: occasionally
often: often
one: one
onto: onto
open: open
opinion: opinion
opposition: opposition
optimization: optimization
order: order
organization: organization
organize: organized
origin: origin
overview: overview
pace: paced
package: package
pair: paired
paper: paper
part: part
participation: participation
pattern: pattern
people: people
percentage: percentage
perform: perform
performance: performance
perpendicular: perpendicular
pet: pet
physiological: physiological
piano: piano
place: place
planar: planar
play: play
point: point
policy: policy
pontifical: pontifical
population: population
porto: porto
positive: positive
possibility: possibility
posterior: posterior
power: power
practical: practical
practically: practically
practice: practice practiced
precentral: precentral
predictability: predictability
predominance: predominance
preference: preference
pregnancy: pregnancy
preparation: preparation
prepared: prepared
present: present
preservation: preservation
presupplementary: presupplementary
previous: previous
previously: previously
primarily: primarily
primary: primary
primate: primate
principal: principal
privacy: privacy
probably: probably
process: process
produce: produce produced
professional: professional
program: program
progressively: progressively
pronounce: pronounced
proofread: proofreading
proper: proper
properly: properly
proportion: proportion
proportionally: proportionally
pst: pst
psych: psych
psychiatric: psychiatric
psychiatry: psychiatry
publication: publication
quantitative: quantitative
questionnaire: questionnaire
quick: quick
rather: rather
reason: reason
receive: receive
recent: recent
recommend: recommend
reconstruction: reconstruction
recovery: recovery
red: red
reduce: reduced
redundant: redundant
reflect: reflect reflected
regard: regarding
regardless: regardless
regional: regional
regression: regression
related: related
relation: relation
relationship: relationship
reorganization: reorganization
representation: representation
reproducibility: reproducibility
research: research
resection: resection
reserve: reserved
resonance: resonance
respect: respect
respective: respective
response: response
rest: rest
result: result
retraction: retraction
review: review
reward: reward
rhesus: rhesus
right: right
rio: rio
role: role
rostral: rostral
run: run
sagittal: sagittal
sample: sample
sao: sao
sar: sar
scale: scale
scan: scanning
scanner: scanner
school: school
science: science
scientific: scientific
scope: scope
score: score
screen: screen
second: second
secondary: secondary
section: section
select: select selected
selection: selection
sense: sense
sensorimotor: sensorimotor
sensory: sensory
separate: separates separating
separately: separately
sequence: sequence
sequential: sequential
series: series
service: service
several: several
shah: shah
share: share
show: shown
side: side sides
signal: signal
significant: significant
significantly: significantly
silicon: silicon
similar: similar
simultaneous: simultaneous
since: since
single: single
site: site
situation: situation
six: six
size: size
skill: skill
sma: sma
small: small
soft: soft
sought: sought
space: space
spar: sparing
spatial: spatial
special: special
specialization: specialization
specific: specific
specifically: specifically
speed: speed
standard: standard
start: start
statement: statement
statistic: statistic statistics
statistical: statistical
steady: steadying
stimulate: stimulate
stimulation: stimulation
stimulus: stimuli
stop: stop
strategy: strategy
strick: strick
strong: strong
structural: structural
structure: structure
student: student
study: studied study
subject: subject
submit: submit
subscription: subscription
subsequent: subsequent
substantially: substantially
substrate: substrate
successively: successively
suggest: suggest
sulcus: sulcus
summary: summary
supplementary: supplementary
support: support supporting
surface: surface
surgical: surgical
system: system
systematically: systematically
table: table
tap: tapping
task: task
temporal: temporal
tendency: tendency
test: test tested
thaler: thaler
third: third
though: though
threshold: threshold
thumb: thumb
thus: thus
ti: ti
time: time timed
timing: timing
told: told
tomography: tomography
top: top
topographic: topographic
topper: topper
total: total
touch: touch touched
toward: toward
towards: towards
train: train
training: training
transient: transient
translation: translation
trigger: triggered
twelve: twelve
two: two
type: type
typical: typical
underlie: underlying
understand: understand
unilateral: unilateral
unimanual: unimanual
university: university
unknown: unknown
unpredictable: unpredictable
us: us
use: use used
value: value
van: van
variation: variation
various: various
verify: verify
view: view
vision: vision
visual: visual
visually: visually
volume: volume
voluntary: voluntary
volunteer: volunteer
wall: wall
wet: wet
whereas: whereas
whether: whether
whole: whole
within: within
without: without
work: work
write: written
ym: ym
york: york
zone: zone
