aa: aa
abb: abb
abstract: abstract
academic: academic
accelerate: accelerated
acceleration: acceleration
access: access
accord: according
accordance: accordance
account: account
act: act
acta: acta
actually: actually
ad: ad
add: add
address: address
adopt: adopt
ae: ae
aer: aer
agreement: agreement
aid: aid
aim: aim
ait: ait
alert: alert
along: along
also: also
alternative: alternative
altogether: altogether
always: always
ami: ami
analysis: analysis
analytic: analytic
ape: ape
appear: appear
approach: approach
arbitrary: arbitrary
archive: archive
around: around
article: article
artifact: artifact
associate: associated
astronomy: astronomy
asymptotic: asymptotic
attempt: attempt
attribution: attribution
author: author
auxiliary: auxiliary
base: based
basis: basis
become: become
becomes: becomes
board: board
briefly: briefly
calculate: calculated
calculation: calculation
canonical: canonical
carry: carried carry
case: case
ce: ce
celebrate: celebrated
center: centered
chain: chain
change: change
check: check
cite: cite
clear: clear
close: close
collect: collect
come: come
comment: comment
common: commons
commutation: commutation
commutator: commutator
comparison: comparison
compatibility: compatibility
complete: complete
complex: complex
concern: concern concerning
conclude: conclude
conclusion: conclusion
condition: condition
conformal: conformal
conjugate: conjugate
connection: connection
consequently: consequently
consider: consider
consist: consist
consistency: consistency
consistent: consistent
constant: constant
contact: contact
continuation: continuation
contravariant: contravariant
contribution: contribution
convenient: convenient
conventional: conventional
conversely: conversely
copyright: copyright
correct: correct
correctly: correctly
correspond: correspond corresponding
covariant: covariant
cover: cover
creative: creative
curve: curved
customer: customer
deal: deal
declare: declare
define: defined
definite: definite
definitely: definitely
degree: degree
department: department
derive: derive
describe: describe
destruction: destruction
detection: detection
di: di
differential: differential
difficult: difficult
dimensional: dimensional
direction: direction
disclaimer: disclaimer
disentanglement: disentanglement
distinguish: distinguished
distribution: distribution
drastic: drastic
dual: dual
due: due
dynamic: dynamics
edition: edition
editorial: editorial
effect: effect effects
electric: electric
electromagnetic: electromagnetic
element: element
emission: emission
emphasis: emphasis
employ: employed
equal: equal
equality: equality
equation: equation
equilibrium: equilibrium
equivalently: equivalently
essential: essential
ethic: ethics
evaluate: evaluate
even: even
eventually: eventually
example: example
exercise: exercise
exist: exist
expansion: expansion
expedient: expedient
experimental: experimental
explicit: explicit
explicitly: explicitly
express: expressed
expression: expression
fictitious: fictitious
field: field
fifth: fifth
file: file
fill: fill
finally: finally
find: find
firm: firm
first: first
flat: flat
follow: follow following
form: form
formalism: formalism
formula: formula
formulation: formulation
found: found
four: four
frame: frame
framework: framework
free: free
freedom: freedom
frequency: frequency
frequently: frequently
fulfill: fulfill
full: full fulling
fully: fully
function: function
future: future
gauge: gauge
general: general
generality: generality
get: get
give: given
greatly: greatly
guideline: guideline
hard: hard
health: health
hence: hence
highly: highly
history: history
hitherto: hitherto
hold: hold
holomorphic: holomorphic
home: home
horizon: horizon
however: however
id: id
imaginary: imaginary
indeed: indeed
indefinite: indefinite
indefinitely: indefinitely
independent: independent
index: indexing
inertial: inertial
initial: initial
inner: inner
instance: instance
instructive: instructive
integral: integral
interest: interest interesting
international: international
introduce: introduce
introduction: introduction
invariant: invariant
inversion: inversion
investigate: investigate
issue: issue
journal: journal
kill: kill killing
know: known
label: label
lack: lack
large: large
latter: latter
left: left
let: let
library: library
license: license licensed
light: light
like: like
line: line
lineal: lineal
literature: literature
local: local
login: login
long: long
longitudinal: longitudinal
loss: loss
make: made
manifestly: manifestly
manner: manner
manuscript: manuscript
massless: massless
matrix: matrix
matter: matter
may: may
menu: menu
meromorphic: meromorphic
method: method
metric: metric
mi: mi
might: might
minus: minus
mode: mode
modern: modern
momentum: momentum
moreover: moreover
motion: motion
move: moving
must: must
namely: namely
natural: natural
nearly: nearly
neatly: neatly
necessarily: necessarily
negative: negative
new: new
news: news
nonphysical: nonphysical
norm: norm
normal: normal
note: note
notice: notice
null: null
observer: observer
obtain: obtain
odd: odd
one: one
open: open
operational: operational
operator: operator
order: order
ordinary: ordinary
orthogonal: orthogonal
owe: owing
pair: pair
paper: paper
parameter: parameter
parity: parity
part: part
perform: perform
physic: physics
physical: physical
plane: plane
plus: plus
polarization: polarization
policy: policy
positive: positive
possess: possess
potential: potential
present: present
preservation: preservation
press: press
privacy: privacy
procedure: procedure
process: process
product: product
production: production
progress: progress
progressive: progressive
proofread: proofreading
propagation: propagation
proper: proper
properly: properly
property: property
provide: provide provided
pst: pst
psych: psych
publication: publication
quadrant: quadrant
quantization: quantization
quantum: quantum
quite: quite
radiation: radiation
read: read
readily: readily
real: real
realistic: realistic
recall: recall
recast: recast
receive: receive
recently: recently
recommend: recommend
refer: refer
reference: reference
region: region
regressive: regressive
related: related
relation: relation
relativity: relativity
relevant: relevant
reliable: reliable
remark: remark
represent: represent
representation: representation
research: research
reserve: reserved
respect: respect
respectively: respectively
restrict: restrict restricted
restriction: restriction
result: result
retraction: retraction
reversal: reversal
review: review
right: right
san: san
sar: sar
satisfied: satisfied
satisfy: satisfy satisfying
scalar: scalar
scientific: scientific
scope: scope
section: section
see: see
select: select selected
seminal: seminal
separate: separate
series: series
service: service
set: set setting
shall: shall
share: share
short: short
similar: similar
simple: simple
simplification: simplification
simplify: simplify
since: since
singularity: singularity
society: society
soft: soft
solid: solid
solution: solution
space: space
spatial: spatial
special: special
specifically: specifically
speed: speed
stand: standing
standard: standard
state: stated
statement: statement
straight: straight
strength: strength
strongly: strongly
study: study
subject: subject
submit: submit
subscription: subscription
subsidiary: subsidiary
suitable: suitable
suitably: suitably
symmetry: symmetry
system: system
table: table
take: taken
task: task
technique: technique
temper: tempered
temperature: temperature
temporal: temporal
tensor: tensor
thanks: thanks
theoretical: theoretical
theory: theory
thereby: thereby
therefrom: therefrom
thermal: thermal
thus: thus
ti: ti
time: time
together: together
top: top
transform: transform
transformation: transformation
translation: translation
treatment: treatment
trigonometric: trigonometric
true: true
turn: turning turns
two: two
uniformly: uniformly
unit: unit
university: university
unless: unless
upon: upon
us: us
use: use
useful: useful
utmost: utmost
valid: valid
van: van
vanish: vanishing
variable: variable
vector: vector
velocity: velocity
verification: verification
verify: verify
view: view
volume: volume
wave: wave
way: way
wedge: wedge
well: well
wet: wet
whence: whence
whereas: whereas
whole: whole
without: without
work: work
write: write written
yet: yet
yield: yield
ym: ym
york: york
zero: zero
