aa: aa
abb: abb
absolute: absolute
absorbed: absorbed
absorption: absorption
abstract: abstract
access: access
accord: according
account: account
accumulation: accumulation
act: act
action: action
ad: ad
add: add
address: address
ae: ae
aer: aer
aid: aid
aim: aim
ait: ait
alert: alert
algebra: algebra
also: also
although: although
always: always
ami: ami
amplitude: amplitude
animate: animating
animation: animation
annihilation: annihilation
another: another
ape: ape
archive: archive
article: article
attribution: attribution
author: author
basic: basic
behavior: behavior
belonging: belonging
board: board
bound: bounded
calculate: calculate
call: call
case: case
ce: ce
cite: cite
classical: classical
column: column
combination: combination
common: commons
company: company
complete: complete
completely: completely
complex: complex
component: component
conclusion: conclusion
conservation: conservation
consist: consist
consistent: consistent
constant: constant
constituent: constituent
contact: contact
continue: continue
copyright: copyright
correspond: correspond
could: could
creation: creation
creative: creative
customer: customer
declare: declare
decrease: decreasing
deference: deference
define: define
definition: definition
derivation: derivation
detection: detection
develop: develop
differential: differential
difficult: difficult
director: director
disclaimer: disclaimer
distance: distance
distinct: distinct
donate: donated
duality: duality
due: due
dynamical: dynamical
edition: edition
editorial: editorial
educational: educational
elementary: elementary
emission: emission
energy: energy
equal: equal
equation: equation
equivalent: equivalent
ethic: ethics
event: event
evolution: evolution
example: example
exchange: exchange
exclusion: exclusion
exist: exist
existence: existence
father: father
field: field
figure: figure
file: file
fill: filled filling
final: final
find: find finding
finite: finite
follow: follow following
form: form
formula: formula
formulation: formulation
founder: founder
free: free
frequently: frequently
fulfill: fulfill
function: function
general: general
give: given
govern: govern governing
grow: growing
guideline: guideline
hand: hand
head: head
health: health
hence: hence
hereinafter: hereinafter
hierarchal: hierarchal
hill: hill
history: history
home: home
however: however
idealization: idealization
identical: identical
imaginary: imaginary
immeasurable: immeasurable
imply: imply
important: important
incorporeal: incorporeal
increase: increase increasing
independent: independent
index: indexing
information: information
ing: ing
initial: initial
inside: inside
instance: instance
interaction: interaction
interest: interest
interference: interference
international: international
interval: interval
introduce: introduce
inverse: inverse
issue: issue
journal: journal
ket: ket
last: last
law: law
leaf: leaves
leave: leave leaving
lecture: lecture
left: left
library: library
license: license licensed
light: light
linear: linear
login: login
make: made
manuscript: manuscript
mass: mass
mathematical: mathematical
matrix: matrix
matter: matter
measurable: measurable
measurement: measurement
mechanic: mechanics
menu: menu
mi: mi
minus: minus
modern: modern
momentum: momentum
motion: motion
must: must
mutual: mutual
mutually: mutually
nature: nature
near: near
need: need
neighbor: neighboring
new: new
news: news
note: note
number: number
occupy: occupy
one: one
open: open
operator: operator
outer: outer
outside: outside
paper: paper
part: part
partial: partial
particle: particle
path: path
pattern: pattern
physic: physics
plank: plank
point: point
policy: policy
preservation: preservation
principle: principle
privacy: privacy
probabilistic: probabilistic
probability: probability
problem: problem
process: process
product: product
proofread: proofreading
proper: proper
prove: prove
pst: pst
psych: psych
publication: publication
quantum: quantum
radius: radius
receive: receive
recommend: recommend
red: red
reformulate: reformulate
reformulation: reformulation
region: region
related: related
relation: relation
relativistic: relativistic
relativity: relativity
replace: replace
represent: represent
representation: representation
requirement: requirement
research: research
reserve: reserved
rest: rest
retraction: retraction
right: right
row: row
sar: sar
sate: sate
satisfy: satisfy
scale: scale
scientific: scientific
scope: scope
select: select
service: service
set: set
shape: shape
share: share
soft: soft
solution: solution
spatial: spatial
special: special
speed: speed
speedometer: speedometer
sphere: sphere
spherical: spherical
start: start
state: state
statement: statement
subject: subject
submit: submit
subscription: subscription
support: support
suppose: suppose
system: system
take: take taking
tell: tell
temporal: temporal
tensor: tensor
thanks: thanks
theorem: theorem
theory: theory
ti: ti
time: time
title: titled
top: top
total: total
transformation: transformation
transition: transition
translation: translation
twice: twice
two: two
unified: unified
universe: universe
us: us
vacuum: vacuum
value: value
van: van
variable: variable
vector: vector
vehicle: vehicle
volume: volume
wave: wave
way: way
wet: wet
wife: wife
work: work
ym: ym
