aa: aa
abb: abb
absolute: absolute
abstract: abstract
access: access
account: account
act: act acting
active: active
ad: ad
add: add
address: address
ae: ae
aer: aer
affine: affine
aid: aid
aim: aim
ait: ait
alert: alert
allow: allow
also: also
ami: ami
analysis: analysis
analytic: analytic
analyze: analyze
annals: annals
another: another
ape: ape
apply: applied
approach: approach
appropriate: appropriate
arbitrariness: arbitrariness
arbitrary: arbitrary
archive: archive
around: around
arrive: arrive
article: article
associate: associated
assume: assume
attribution: attribution
autonomous: autonomous
back: back
background: background
bank: bank
basic: basic
berlin: berlin
board: board
boston: boston
bound: bounded
boundedness: boundedness
bulletin: bulletin
cam: cam
carry: carried
case: case
ce: ce
central: central
certain: certain
change: change
characterization: characterization
choose: choose
circumstance: circumstance
cite: cite
class: class
classical: classical
collection: collection
common: commons
compact: compact
complete: complete
composition: composition
con: con
concept: concept
conclude: conclude
condition: condition
consequently: consequently
consider: consider considered considering
constant: constant
contact: contact
context: context
continuity: continuity
continuous: continuous
contradiction: contradiction
converge: converge
convergence: convergence
converse: converse
copyright: copyright
could: could
creative: creative
crucial: crucial
customer: customer
day: day
de: de
deal: dealing
declare: declare
decrease: decreasing
define: define defined
definition: definition
denote: denote
depend: depend
description: description
detailed: detailed
detection: detection
develop: develop
devote: devoted
diameter: diameter
difference: difference
different: different
differential: differential
direction: direction
disclaimer: disclaimer
do: done
dudley: dudley
due: due
editorial: editorial
el: el
emergency: emergency
empirical: empirical
en: en
ensure: ensure
equal: equal
equation: equation
equidistant: equidistant
estimate: estimate
ethic: ethics
even: even
every: every
example: example
exhibit: exhibit
exist: exist
existence: existence
expand: expand
exponent: exponent
family: family
fan: fan
field: field
file: file
finally: finally
find: find
finite: finite
first: first
fix: fixed
follow: follow following
form: form formed
found: found
free: free
frequently: frequently
function: function
functional: functional
general: general
generality: generality
generalize: generalized
generally: generally
geometric: geometric
get: get
give: gave give given
group: group
growth: growth
guideline: guideline
hand: hand
harmonic: harmonic
health: health
hence: hence
hiatus: hiatus
history: history
home: home
however: however
hypothesis: hypothesis
id: id
image: image
implication: implication
important: important
increase: increasing
index: indexing
inequality: inequality
infinite: infinite
information: information
ing: ing
integral: integral
interest: interest interesting
international: international
interval: interval
introduce: introduce
introduction: introduction
inverse: inverse
issue: issue
jordan: jordan
journal: journal
kind: kind
know: known
la: la
last: last
later: later
least: least
lecture: lecture
left: left
lemma: lemma
let: let
liang: liang
library: library
license: license licensed
limit: limit
line: line
linear: linear
link: links
local: local
locally: locally
location: location
login: login
long: long
loss: loss
love: love
main: main
mainly: mainly
major: major
make: made
manuscript: manuscript
many: many
map: map
mathematical: mathematical
mathematics: mathematics
maximal: maximal
may: may
measure: measure
mediterranean: mediterranean
menu: menu
metric: metric
mi: mi
modular: modular
monograph: monograph
monotone: monotone
must: must
namely: namely
necessarily: necessarily
necessary: necessary
nelson: nelson
new: new
news: news
next: next
nonexistence: nonexistence
nonincreasing: nonincreasing
nonlinear: nonlinear
norm: norm
notable: notable
notation: notation
notion: notion
number: number
obtain: obtain
one: one
open: open
operator: operator
order: order
organize: organized
oscillation: oscillation
paper: paper
partial: partial
partially: partially
partition: partition
partly: partly
passing: passing
phenomenon: phenomena
physic: physics
physical: physical
pick: pick
play: play
point: point
policy: policy
polish: polish
pollard: pollard
position: position
positive: positive
positivity: positivity
preservation: preservation
press: press
privacy: privacy
probabilistic: probabilistic
problem: problem
proof: proof
proofread: proofreading
prove: prove proved
provide: provide
pst: pst
psych: psych
publication: publication
pure: pure
purpose: purpose
put: put
quadratic: quadratic
qualitative: qualitative
question: question
raise: raised
real: real
receive: receive
recent: recent
recommend: recommend
refer: refer
regular: regular
regularity: regularity
regularization: regularization
related: related
remainder: remainder
remark: remark
representation: representation
research: research
reserve: reserved
respect: respect
respectively: respectively
result: result
retraction: retraction
revival: revival
rich: rich
right: right
rise: rise
role: role
sar: sar
satisfy: satisfy satisfying
say: say
scientific: scientific
scope: scope
sec: sec
second: second
section: section
see: see
select: select
sense: sense
sequence: sequence
series: series
service: service
set: set
share: share
show: show shown
side: side
similar: similar
similarly: similarly
since: since
situation: situation
six: six
ski: ski
soft: soft
solution: solution
source: source
space: space
special: special
spirit: spirit
springer: springer
staff: staff
standard: standard
statement: statement
statistic: statistics
strictly: strictly
structural: structural
studia: studia
study: studied study
subject: subject
submit: submit
subscription: subscription
subset: subset
sufficient: sufficient
suitable: suitable
superposition: superposition
suppose: suppose supposed
sur: sur
symbol: symbol
symmetry: symmetry
system: system
systematic: systematic
tag: tagged
take: take taken taking
thanks: thanks
theorem: theorem
theoretical: theoretical
theory: theory
therefore: therefore
threefold: threefold
throughout: throughout
thus: thus
ti: ti
together: together
top: top
topological: topological
topology: topology
translation: translation
trivial: trivial
two: two
type: type
uniform: uniform
uniformly: uniformly
union: union
university: university
us: us
use: use
variable: variable
variation: variation
variational: variational
variety: variety
various: various
virtue: virtue
vol: vol
volume: volume
want: want
way: way
weak: weak
well: well
wet: wet
wide: wide
wiener: wiener
without: without
work: work
write: write
yang: yang
year: year
yield: yield
yin: yin
ym: ym
york: york
young: young
