aa: aa
abb: abb
abstract: abstract
access: access
act: act
active: active
actual: actual
ad: ad
add: add
address: address
advantageous: advantageous
ae: ae
aer: aer
aid: aid
aim: aim
ait: ait
alert: alert
algebra: algebra
algebraic: algebraic
algorithm: algorithm
also: also
always: always
ami: ami
analysis: analysis
ape: ape
apply: applied
archive: archive
area: area
arise: arise
arithmetic: arithmetic
arm: armed
article: article
associate: associated
attention: attention
attribution: attribution
author: author
available: available
base: based
basic: basic
begin: begun
blank: blank
board: board
border: bordered
boundary: boundary
case: case
ce: ce
cite: cite
clearly: clearly
code: code
coefficient: coefficient
common: commons
computation: computation
computational: computational
computer: computer
consider: consider considered considering
consideration: consideration
construct: construct
contact: contact
copyright: copyright
correspond: corresponding
cost: cost
could: could
creative: creative
current: current
customer: customer
declare: declare
department: department
derive: derived
detection: detection
determinant: determinant
differential: differential
disclaimer: disclaimer
doubly: doubly
easily: easily
editorial: editorial
equation: equation
ethic: ethics
even: even
example: example
expression: expression
extension: extension
factor: factor
factorization: factorization
faculty: faculty
family: family
fast: fast
file: file
finally: finally
finite: finite
float: floating
flop: flop
focus: focus
follow: follow following
form: form
formal: formal
formulate: formulate
four: four
free: free
frequently: frequently
general: general
generalization: generalization
generalize: generalized
give: given
go: going
guideline: guideline
health: health
hence: hence
history: history
hold: hold
home: home
illustrative: illustrative
importance: importance
index: indexing
instance: instance
interest: interest
interested: interested
international: international
interpolation: interpolation
introduce: introduce
introduction: introduction
inverse: inverse
inversion: inversion
issue: issue
journal: journal
last: last
later: later
library: library
license: license licensed
linear: linear
login: login
manuscript: manuscript
many: many
maple: maple
mathematics: mathematics
matrix: matrices matrix
may: may
menu: menu
mi: mi
name: name
natural: natural
necessarily: necessarily
new: new
news: news
next: next
nonsingular: nonsingular
note: note
notice: notice
novel: novel
nth: nth
number: number
one: one
open: open
order: order
organize: organized
paper: paper
parallel: parallel
parameter: parameter
partition: partition partitioned
periodic: periodic
physic: physics
point: point
policy: policy
possible: possible
present: present
preservation: preservation
privacy: privacy
proof: proof
proofread: proofreading
pst: pst
psych: psych
publication: publication
rational: rational
reader: reader
receive: receive
recently: recently
recommend: recommend
recursive: recursive
refer: refer
related: related
remark: remark
remove: remove
request: request
research: research
reserve: reserved
retraction: retraction
sar: sar
satisfied: satisfied
science: science
scientific: scientific
scope: scope
section: section
see: see seen
select: select
service: service
share: share
show: shown
simplify: simplify
singular: singular
soft: soft
solution: solution
special: special
statement: statement
step: step
structure: structure
subject: subject
submit: submit
subscription: subscription
symbolic: symbolic
system: system
telecommunication: telecommunication
theorem: theorem
throughout: throughout
thus: thus
ti: ti
together: together
top: top
total: total
translation: translation
type: type
university: university
upon: upon
us: us
value: value
via: via
view: view
volume: volume
wet: wet
whose: whose
word: word
work: work
write: written
ym: ym
