aa: aa
abb: abb
abstract: abstract
access: access
accuracy: accuracy
accurate: accurate
accurately: accurately
across: across
act: act
active: active
ad: ad
add: add
address: address
ae: ae
aer: aer
aid: aid
aim: aim
ait: ait
alert: alert
allow: allow
also: also
alternative: alternative
ami: ami
amplifier: amplifier
analysis: analysis
another: another
ape: ape
application: application
architecture: architecture
archive: archive
area: area
article: article
attention: attention
attribution: attribution
automatic: automatic
band: band
base: based
basic: basic
block: block
board: board
buffer: buffer
building: building
bulky: bulky
capable: capable
capacitance: capacitance
capacitor: capacitor
case: case
ce: ce
center: center
chip: chip
choice: choice
circuit: circuit
cite: cite
close: closed
combination: combination
comment: comment
common: commons
communication: communication
comparison: comparison
complete: complete
conclusion: conclusion
configuration: configuration
considerable: considerable
contact: contact
control: control
controller: controller
converter: converter
copyright: copyright
cost: cost
couple: coupling
creative: creative
current: current
customer: customer
declare: declare
department: department
derivation: derivation
description: description
design: design designed
detection: detection
diagram: diagram
different: different
differential: differential
directly: directly
disclaimer: disclaimer
discrete: discrete
distortion: distortion
divider: divider
due: due
dynamic: dynamic
ease: ease
easy: easy
editorial: editorial
effect: effect
electronics: electronics
elimination: elimination
equation: equation
equivalent: equivalent
ethic: ethics
external: external
far: far
feedback: feedback
fet: fet
figure: figure
file: file
filter: filter
first: first
float: floating
follow: follow following
form: form
found: found
free: free
frequency: frequency
frequently: frequently
gain: gain
general: general
generalize: generalized
get: get
give: given
ground: grounded
guideline: guideline
health: health
high: high
highly: highly
history: history
home: home
impedance: impedance
implementation: implementation
independent: independent
index: indexing
inductance: inductance
inductor: inductor
input: input
institute: institute
interest: interest
international: international
introduction: introduction
inversely: inversely
issue: issue
journal: journal
know: known
laser: laser
least: least
less: less
library: library
license: license licensed
linear: linear
linearity: linearity
literature: literature
login: login
loop: loop
maharaja: maharaja
main: main
make: made make
manuscript: manuscript
mathematical: mathematical
menu: menu
mi: mi
minimum: minimum
moderate: moderate
multiplier: multiplier
mutual: mutual
nay: nay
negative: negative
new: new
news: news
node: node
non: non
notch: notch
novel: novel
number: number
objective: objective
open: open
operational: operational
organize: organized
oscillation: oscillation
oscillator: oscillator
output: output
paper: paper
pas: pass
passive: passive
pin: pin
please: please
plus: plus
policy: policy
popular: popular
port: port
present: present
preservation: preservation
privacy: privacy
proofread: proofreading
proportional: proportional
prototype: prototype
pst: pst
psych: psych
publication: publication
purpose: purpose
quality: quality
range: range
rate: rate
realization: realization
realize: realizing
receive: receive
recently: recently
recommend: recommend
reduce: reduced
reference: reference
related: related
relatively: relatively
replace: replace
research: research
reserve: reserved
resistance: resistance
respectively: respectively
response: response
result: result
retraction: retraction
sar: sar
scientific: scientific
scope: scope
see: see seen
select: select
service: service
several: several
share: share
show: show shown
sign: sign
signal: signal
simple: simple
simplification: simplification
simulation: simulation
simulator: simulator
single: single
size: size
slew: slew
soft: soft
special: special
squarer: squarer
standard: standard
statement: statement
structure: structure
subject: subject
submit: submit
subscription: subscription
suitable: suitable
symbol: symbol
synthesis: synthesis
system: system
table: table
technology: technology
terminal: terminal
theory: theory
therefore: therefore
thus: thus
ti: ti
top: top
transaction: transaction
transfer: transfer
translation: translation
trim: trimming
tunable: tunable
two: two
type: type
undesirable: undesirable
universal: universal
us: us
use: use used
useful: useful
value: value
variable: variable
variation: variation
variety: variety
various: various
versatile: versatile
voltage: voltage
volume: volume
well: well
wet: wet
wide: wide
widen: widen
work: work
workability: workability
ym: ym
