aa: aa
abb: abb
ability: ability
able: able
absence: absence
abstract: abstract
abstraction: abstraction
acceptance: acceptance
accepted: accepted
access: access
accessible: accessible
accord: according
accordingly: accordingly
account: account
accurate: accurate
act: act
activate: activate
activation: activation
activity: activity
actual: actual
actually: actually
ad: ad
adaptation: adaptation
adaption: adaption
adaptive: adaptive
add: add
additional: additional
additionally: additionally
address: address
adequate: adequate
adjacent: adjacent
adopt: adopted
adoption: adoption
ae: ae
aer: aer
affected: affected
aid: aid
aim: aim aiming
ait: ait
alert: alert
algorithm: algorithm
algorithmic: algorithmic
allow: allow
alphabet: alphabet
already: already
also: also
alter: alter
always: always
ami: ami
analysis: analyses analysis
ann: ann
annual: annual
another: another
ape: ape
applicability: applicability
applicable: applicable
application: application
apply: applied apply
approach: approach
appropriate: appropriate
arbor: arbor
architectural: architectural
architecture: architecture
archive: archive
art: art
article: article
artifact: artifact
aspect: aspect
assess: assess
assume: assume assumed
assumption: assumption
assurance: assurance
attention: attention
attribution: attribution
august: august
automatic: automatic
automatically: automatically
automaton: automata automaton
automotive: automotive
autonomous: autonomous
available: available
avoid: avoid
bach: bach
back: back
badger: badger
baker: baker
barth: barth
base: based
basic: basic
basis: basis
become: become becoming
bed: bed
beer: beer
behave: behave
behavior: behavior
behavioral: behavioral
behaviour: behaviour
bel: bel
bender: bender
benefit: benefit
berlin: berlin
besides: besides
bit: bit
black: black
block: block
board: board
boundary: boundary
box: box
bridge: bridge
bridging: bridging
building: building
built: built
bus: bus
call: call
cape: cape
case: case
category: category
causal: causal
cause: cause
ce: ce
certain: certain
certification: certification
challenge: challenge
cham: cham
change: change
changeability: changeability
chart: chart
check: check
checker: checker
circuit: circuit
cite: cite
class: class classes
classical: classical
classification: classification
classify: classified
clearer: clearer
close: close
cluster: clustered
code: code
cognitive: cognitive
combination: combination
combine: combined
commission: commission
common: common commons
commonly: commonly
communicate: communicating
communication: communication
community: community
compare: compare
comparison: comparison
complementary: complementary
complete: complete
completely: completely
complex: complex
compliance: compliance
complicate: complicated
component: component
compose: composed
comprehensive: comprehensive
computational: computational
compute: compute
computer: computer
conceptual: conceptual
concern: concerning
concerned: concerned
conclusion: conclusion
conduct: conduct
conference: conference
confirm: confirm
confirmation: confirmation
conform: conform
conformance: conformance
confuse: confused
connect: connected
connection: connection
consequently: consequently
consider: consider considered considering
consist: consist
consistent: consistent
consolidate: consolidate
constant: constant
contact: contact
context: context
continuation: continuation
continuous: continuous
contrast: contrast
control: control
controllable: controllable
controller: controller
copyright: copyright
correct: correct
corrective: corrective
correctness: correctness
correspond: corresponding
cost: cost
could: could
counter: counter
course: course
coverage: coverage
create: create
creation: creation
creative: creative
criterion: criteria criterion
critical: critical
cross: cross
current: current
currently: currently
customer: customer
cybernetics: cybernetics
cycle: cycle
cyclic: cyclic
data: data
de: de
declare: declare
defective: defective
define: define defined
definition: definition
delay: delay
delft: delft
depend: depending
dependability: dependability
dependable: dependable
dependence: dependence
dependency: dependency
dependent: dependent
derive: derive derived
description: description
design: design designed
detailed: detailed
detection: detection
determine: determined
deterministic: deterministic
develop: develop
development: development
deviation: deviation
device: device
diagram: diagram
different: different
dimension: dimension
din: din
direct: direct directed
directly: directly
disclaimer: disclaimer
discover: discovered
discrete: discrete
discussion: discussion
distinction: distinction
distinguish: distinguish distinguished distinguishing
distribute: distributed
divide: divided
do: done
domain: domain
dominant: dominant
driven: driven
due: due
dynamic: dynamic
dynamically: dynamically
early: early
easily: easily
easy: easier
edge: edge
edition: edition
editorial: editorial
effect: effects
effectiveness: effectiveness
efficiency: efficiency
efficient: efficient
effort: effort
either: either
electrical: electrical
electromagnetic: electromagnetic
electronic: electronic
electronics: electronics
electrotechnical: electrotechnical
enable: enable
encode: encode
encompass: encompass
engineering: engineering
enough: enough
ensure: ensure
environment: environment
equivalence: equivalence
equivalently: equivalently
error: error
especially: especially
establish: established
ethic: ethics
evaluate: evaluate
evaluation: evaluation
even: even
event: event
every: every
evolution: evolution
exactly: exactly
examine: examine
example: example
exception: exception
exclude: excluding
executable: executable
execute: executed
execution: execution
exhaustive: exhaustive
exist: exist
expand: expanded
experimental: experimental
explicit: explicit
exploration: exploration
explore: explore
extend: extended
extension: extension
extensive: extensive
external: external
extra: extra
extract: extract extracted
extraction: extraction
fact: fact
factor: factor
factory: factory
fail: fail failing
failure: failure
false: false
far: far
fault: fault
faulty: faulty
fay: fay
fed: fed
feedback: feedback
fey: fey
fi: fi
field: field
figure: figure
file: file
final: final
find: find
finite: finite
first: first
fix: fixed
flexible: flexible
flow: flow
focus: focus
follow: follow following
force: forcing
form: form
formal: formal
formalism: formalism
formalization: formalization
formalize: formalize
former: former
found: found
free: free
frequently: frequently
friendly: friendly
fruitful: fruitful
full: full
function: function
functional: functional
furthermore: furthermore
gap: gap
gather: gather
general: general
generate: generate generating
generation: generation
generic: generic
german: german
get: get
give: give given giving
global: global
glossary: glossary
goal: goal
graph: graph
graphical: graphical
guideline: guideline
hand: hand
handle: handle handled handling
hardware: hardware
harman: harman
health: health
help: help
hesitant: hesitant
hierarchical: hierarchical
high: high
history: history
hold: hold
home: home
however: however
huge: huge
human: human
identification: identification
identify: identify
image: image
impact: impact
implement: implement
implementation: implementation
implicit: implicit
importance: importance
important: important
improve: improve improving
improvement: improvement
include: include included
inclusion: inclusion
incomplete: incomplete
inconclusive: inconclusive
increase: increase increasing
increasingly: increasingly
independently: independently
index: indexing
industrial: industrial
industry: industry
infinitely: infinitely
influence: influence
informal: informal
information: information
ingenuity: ingenuity
inject: inject
injection: injection
input: input
instance: instance
institute: institute
institution: institution
instruction: instruction
instrumentation: instrumentation
integrate: integrate
integration: integration
intend: intended
interaction: interaction
interest: interest interesting
interested: interested
interference: interference
internal: internal
international: international
intricate: intricate
introduce: introduce
introduction: introduction
investigation: investigation
investment: investment
issue: issue
journal: journal
june: june
keep: keeping
key: key
kind: kind
know: known
knowledge: knowledge
ladder: ladder
language: language
last: last
later: later
latter: latter
lead: lead leading
learn: learned
least: least
lecture: lecture
lee: lee
level: level
library: library
license: license licensed
like: like
likely: likely
limit: limiting
link: linked
list: list
little: little
litz: litz
load: loaded
local: local
log: logging
logic: logic
logical: logical
login: login
lot: lot
low: lower
machine: machine
main: main
mainly: mainly
maintenance: maintenance
major: major
make: made make making
malik: malik
man: man
management: management
manipulation: manipulation
manual: manual
manually: manually
manuscript: manuscript
many: many
march: march
may: may
mealy: mealy
meaning: meaning
measure: measure
mechanical: mechanical
mechanism: mechanism
menu: menu
method: method
methodology: methodology
mi: mi
might: might
mil: mil
minimization: minimization
miss: missing
model: model modeling
modification: modification
morel: morel
mostly: mostly
much: much
must: must
mutant: mutant
mutation: mutation
namely: namely
need: need needs
negative: negative
neither: neither
net: net
nevertheless: nevertheless
new: new
news: news
next: next
notation: notation
note: note
nothing: nothing
nuclear: nuclear
number: number
numerous: numerous
object: object
objective: objective
observability: observability
observable: observable
observation: observation
occur: occur
occurrence: occurrence
offering: offering
often: often
one: one
open: open
operating: operating
operation: operation
operational: operational
operator: operator
opportunity: opportunity
opposite: opposite
optimization: optimization
order: order ordered
originally: originally
output: output
overview: overview
paper: paper
paradigm: paradigm
part: part
partial: partial
partially: partially
particularly: particularly
pas: pass
past: past
path: path
per: per
pereira: pereira
perfective: perfective
performance: performance
permanent: permanent
permit: permitted
personnel: personnel
petit: petit
phase: phase phases
physical: physical
pin: pin
plant: plant
plus: plus
point: point
policy: policy
porto: porto
positive: positive
possible: possible
power: power
practice: practice
precede: preceding
preservation: preservation
press: press
previous: previous
primary: primary
privacy: privacy
problematic: problematic
procedural: procedural
process: process
processor: processor
production: production
professorship: professorship
profile: profile
program: program
promising: promising
prone: prone
proofread: proofreading
property: property
protocol: protocol
prove: prove proving
proven: proven
provide: provide providing
provost: provost
pst: pst
psych: psych
public: public
publication: publication
put: put
quality: quality
quantitative: quantitative
question: question
quiescence: quiescence
random: random
rare: rare
rarely: rarely
rather: rather
reach: reach
reaction: reaction
reactive: reactive
reader: reader
real: real
realize: realize
reason: reason
receive: receive
recent: recent
recently: recently
recommend: recommend
record: recording
reduce: reduced
reduction: reduction
reflect: reflecting
regard: regard regarding
region: region
regression: regression
regularly: regularly
reif: reif
related: related
relation: relation
relevance: relevance
relevant: relevant
reliability: reliability
reliable: reliable
rely: rely
remain: remain
remainder: remainder
remains: remains
repeat: repeated
repetitive: repetitive
represent: represent
representation: representation
reproducible: reproducible
require: require
research: research
reserve: reserved
respect: respect
respective: respective
respectively: respectively
response: response
result: result resulting
retraction: retraction
return: return
review: review
right: right
robustness: robustness
root: root rooted
run: run running
ryder: ryder
safe: safe
safety: safety
san: san
sar: sar
scale: scale
scarce: scarce
scarcely: scarcely
science: science
scientific: scientific
scope: scope
search: search
second: second
section: section
secure: secure
security: security
see: see seen
seem: seem
select: select selected
selection: selection
selective: selective
semantics: semantics
sen: sen
sensor: sensor
separation: separation
sequence: sequence
sequential: sequential
serve: serve
service: service
set: set
setup: setup
several: several
shah: shah
share: share
shi: shi
shorten: shorten
show: shown
side: side
signal: signal
significance: significance
significantly: significantly
sil: sil
silva: silva
similar: similar
simple: simple
simplify: simplified
simply: simply
simulate: simulate
simulation: simulation
since: since
single: single
situation: situation
slice: sliced
society: society
soft: soft
solely: solely
solicit: solicited
solution: solution
sometimes: sometimes
son: sons
sorrento: sorrento
sound: sound
source: source
special: special
specific: specific
specification: specification
specify: specify
speed: speed
spread: spread
springer: springer
standard: standard
standardize: standardize standardized
state: state stated
statement: statement
static: static
statically: statically
status: status
stem: stemming
step: step
still: still
stochastic: stochastic
straight: straight
strategy: strategy
stress: stress
structural: structural
structure: structure structured
study: study
subject: subject
submit: submit
subscription: subscription
subsequent: subsequent
subsequently: subsequently
suggest: suggesting
suitability: suitability
suitable: suitable
suite: suite
sung: sung
supply: supply
support: support supporting
suppose: supposed
survey: survey
suspension: suspension
symbolic: symbolic
symposium: symposium
synchronization: synchronization
synchronize: synchronized
synchronous: synchronous
synthesis: synthesis
system: system
table: table
tackle: tackling
take: take taken taking
target: target targeted
task: task
taxonomy: taxonomy
technical: technical
technique: technique
technology: technology
tedious: tedious
temporal: temporal
term: term
test: test tested testing
textual: textual
theoretical: theoretical
therefore: therefore
third: third
thorough: thorough
thoroughly: thoroughly
though: though
three: three
throughout: throughout
thus: thus
ti: ti
tilbury: tilbury
time: time timed times
timing: timing
tip: tip
today: today
tolerance: tolerance
tolerant: tolerant
tool: tool
top: top
topic: topic
towards: towards
town: town
trace: trace
traceability: traceability
traceable: traceable
training: training
transfer: transfer
transform: transform transforming
transformation: transformation
transition: transition
translation: translation
trigger: triggered
true: true
two: two
type: type
typical: typical
typically: typically
uncertain: uncertain
uncommon: uncommon
unfold: unfolding
unified: unified
unintended: unintended
ural: ural
us: us
usability: usability
usage: usage
use: use used
useful: useful
user: user
usual: usual
usually: usually
valid: valid
validate: validate
validation: validation
validity: validity
value: value
van: van
variant: variant
various: various
vary: vary
vector: vector
verdict: verdict
verification: verification
version: version
via: via
viable: viable
vol: vol
voltage: voltage
volume: volume
way: way ways
weber: weber
well: well
wellington: wellington
wet: wet
whenever: whenever
whether: whether
white: white
whole: whole
widely: widely
winter: winter
within: within
without: without
wong: wong
work: work works
workshop: workshop
world: world
would: would
write: written
xi: xi
yet: yet
ym: ym
york: york
yuan: yuan
zander: zander
zero: zero
