aa: aa
abb: abb
absorption: absorption
abstract: abstract
access: access
accord: according
acetic: acetic
acetylene: acetylene
acid: acid
act: act
action: action
active: active
activity: activity
ad: ad
add: add
addition: addition
additional: additional
address: address
adjacent: adjacent
ae: ae
aer: aer
agent: agent
agonist: agonist
aid: aid
aim: aim
ait: ait
aldehyde: aldehyde
alert: alert
aliphatic: aliphatic
almost: almost
already: already
also: also
aluminum: aluminum
ami: ami
amine: amine
amino: amino
aminoguanidine: aminoguanidine
amount: amount
anal: anal
analysis: analyses analysis
analytical: analytical
analyzer: analyzer
annual: annual
another: another
anti: anti
anticancer: anticancer
antiviral: antiviral
anxiety: anxiety
ape: ape
apparatus: apparatus
aqueous: aqueous
arch: arch
archive: archive
aromatic: aromatic
article: article
aryl: aryl
ascites: ascites
assay: assay
associate: associated
asymmetry: asymmetry
atom: atom
attack: attack
attribution: attribution
author: author
availability: availability
band: band
base: base
basic: basic
bath: bath
bearing: bearing
benzene: benzene
bicarbonate: bicarbonate
biological: biological
biology: biology
board: board
boil: boiling
bold: bold
bond: bond
bonding: bonding
breast: breast
bridgehead: bridgehead
brownish: brownish
cancer: cancer
carbon: carbon
carboxylate: carboxylate
carcinoma: carcinoma
carling: carling
ce: ce
cell: cell
center: center
characteristic: characteristic
characterization: characterization
chemical: chemical
chemistry: chemistry
chloroformate: chloroformate
cite: cite
clinical: clinical
close: closed
closure: closure
cold: cold
common: common commons
compensate: compensate
compound: compound
concentration: concentration
conclusion: conclusion
condensation: condensation
condense: condensed
confirm: confirming
conjugation: conjugation
consider: considered
contact: contact
control: control
convenient: convenient
cook: cook
cool: cool cooling
copyright: copyright
correspond: corresponding
creative: creative
crystallize: crystallized
current: current
customer: customer
cyanoacetate: cyanoacetate
cycle: cycle
cyclic: cyclic
cytotoxic: cytotoxic
damage: damage
data: data
declare: declare
deformation: deformation
department: department
derivative: derivative
derive: derived
design: design
detection: detection
determine: determined
develop: develop
development: development
developmental: developmental
deviation: deviation
di: di
diethyl: diethyl
difference: difference
different: different
differential: differential
dimethyl: dimethyl
direct: direct
disclaimer: disclaimer
discovery: discovery
discussion: discussion
dispensable: dispensable
display: display
displayed: displayed
distort: distorted
diversity: diversity
division: division
doublet: doublet
drug: drug
dual: dual
due: due
editorial: editorial
effect: effect effects
effective: effective
efficacy: efficacy
efficient: efficient
electron: electron
electronic: electronic
electrothermal: electrothermal
elemental: elemental
eleven: eleven
emphasis: emphasis
enhance: enhanced
entry: entry
enzyme: enzyme
equimolar: equimolar
equipotent: equipotent
era: era
especially: especially
essential: essential
estimate: estimate
ethanol: ethanol
ethic: ethics
ethyl: ethyl
evaluate: evaluate
evaluation: evaluation
ex: ex
examination: examination
exhibit: exhibit
experimental: experimental
exposure: exposure
extend: extended
faculty: faculty
faint: faint
feature: feature
figure: figure
file: file
fluorine: fluorine
follow: follow
form: form
formamide: formamide
formation: formation
former: former
found: found
four: four
framework: framework
free: free
frequently: frequently
functional: functional
furthermore: furthermore
fuse: fused
gene: gene
give: gave give giving
glacial: glacial
golden: golden
good: good
grateful: grateful
group: group
growth: growth
guideline: guideline
halogen: halogen
health: health
hetero: hetero
heterocyclic: heterocyclic
high: high higher
highly: highly
history: history
home: home
homogeneity: homogeneity
hour: hour
house: house
however: however
human: human
hydrate: hydrate
hydrazine: hydrazine
hydrogen: hydrogen
hydrolysis: hydrolysis
hydrophobic: hydrophobic
ice: ice
immune: immune
important: important
independent: independent
index: index indexing
induced: induced
infrared: infrared
inhibition: inhibition
inhibitory: inhibitory
interaction: interaction
interest: interest interesting
intermediate: intermediate
intermolecular: intermolecular
internal: internal
international: international
introduce: introduce
introduction: introduction
involve: involved
ion: ion
isolated: isolated
issue: issue
jane: jane
journal: journal
ketone: ketone
kinase: kinase
king: king
knockout: knockout
latter: latter
leach: leach
lead: led
lee: lee
left: left
less: less
lethal: lethal
leukemia: leukemia
library: library
license: license licensed
literature: literature
login: login
loss: loss
low: low
lung: lung
mainly: mainly
make: made
malonate: malonate
malonic: malonic
manuscript: manuscript
marked: marked
mass: mass
master: master
material: material
maximum: maximum
measure: measure measured
mechanism: mechanism
medical: medical
medicinal: medicinal
melt: melting
membrane: membrane
menu: menu
metabolic: metabolic
metabolite: metabolite
method: method
methyl: methyl
mi: mi
millennium: millennium
miller: miller
min: min
mixture: mixture
moderate: moderate
moiety: moiety
molecular: molecular
molecule: molecule
monochloro: monochloro
monochloroacetic: monochloroacetic
moreover: moreover
morgan: morgan
mouse: mouse
multiplet: multiplet
new: new
news: news
nitrogen: nitrogen
note: note
novel: novel
often: often
oh: oh
onto: onto
open: open
orange: orange
organic: organic
owe: owing
oxygen: oxygen
palmer: palmer
paper: paper
part: part
peak: peak
pellet: pellet
perform: perform
perkin: perkin
permeability: permeability
pharmaceutical: pharmaceutical
pharmacological: pharmacological
pharmacology: pharmacology
phase: phase
phenyl: phenyl
phosphorus: phosphorus
pike: pike
piperidine: piperidine
placement: placement
play: play
plus: plus
point: point
polar: polar
policy: policy
polycyclic: polycyclic
positive: positive
possible: possible
potent: potent
potential: potential
precipitate: precipitated
prepared: prepared
presence: presence
present: present
preservation: preservation
privacy: privacy
probable: probable
produce: produced
profound: profound
progression: progression
prominent: prominent
promising: promising
proofread: proofreading
protein: protein
provide: provided providing
pst: pst
psych: psych
publication: publication
pyrazole: pyrazole
pyruvate: pyruvate
quantity: quantity
quite: quite
radical: radical
rational: rational
rationale: rationale
reaction: reaction
reactivity: reactivity
reader: reader
receive: receive
receptor: receptor
recommend: recommend
reference: reference
refluxed: refluxed
regulation: regulation
regulator: regulator
related: related
renal: renal
repair: repair
represent: represent
representative: representative
research: research
reserve: reserved
resonance: resonance
respect: respect
respectively: respectively
response: response
result: result
retraction: retraction
reveal: reveal revealed
review: review
ring: ring
role: role
room: room
sar: sar
scaffold: scaffold scaffolding
scheme: scheme
science: science
scientific: scientific
scope: scope
search: search
second: second
select: select
selective: selective
semicarbazide: semicarbazide
sensitive: sensitive
sensitivity: sensitivity
series: series
service: service
share: share
shih: shih
show: showing shown
signal: signal
significant: significant
silica: silica
silicon: silicon
similar: similar
single: single
singlet: singlet
slightly: slightly
small: small
smart: smart
smith: smith
sodium: sodium
soft: soft
solid: solid
solution: solution
solvent: solvent
special: special
spectral: spectral
spectrometer: spectrometer
spectrometric: spectrometric
spectrometry: spectrometry
spectrophotometer: spectrophotometer
spectrum: spectra spectrum
splitting: splitting
stability: stability
standard: standard
start: starting
statement: statement
station: station
statistical: statistical
steven: steven
strategic: strategic
street: street
strength: strength
strong: strong
structural: structural
structure: structure
study: studied
subject: subject
submit: submit
subpanel: subpanel
subscription: subscription
subsequently: subsequently
substituent: substituent
substitute: substituted
subtype: subtype
synthesis: synthesis
synthesize: synthesize
synthetic: synthetic
system: system
ta: ta
table: table
technique: technique
temperature: temperature
test: tested testing
theoretical: theoretical
therapeutic: therapeutic therapeutics
thioamide: thioamide
thiourea: thiourea
though: though
three: three
thus: thus
ti: ti
title: title
top: top
total: total
toward: toward
towards: towards
transcription: transcription
transformation: transformation
translation: translation
treatment: treatment
triazine: triazine
triethyl: triethyl
triethylamine: triethylamine
trigger: triggered
tumor: tumor
twenty: twenty
two: two
tye: tye
type: type
uncondensed: uncondensed
uncorrected: uncorrected
university: university
unshared: unshared
us: us
use: use used
value: value
variable: variable
various: various
via: via
viability: viability
virus: virus
volume: volume
warm: warming
well: well
wet: wet
whereby: whereby
white: white
within: within
work: work
workman: workman
would: would
yellow: yellow
yellowish: yellowish
yield: yield
ym: ym
