aa: aa
abb: abb
abstract: abstract
access: access
act: act
acta: acta
ad: ad
add: add
address: address
ae: ae
aer: aer
aid: aid
aim: aim
ait: ait
alert: alert
ami: ami
analogue: analogue
analysis: analysis
ape: ape
apply: applied
archive: archive
article: article
asymptotic: asymptotic
asymptotically: asymptotically
attribution: attribution
board: board
bound: bounded
boundedness: boundedness
bulletin: bulletin
ce: ce
certain: certain
cite: cite
colloquium: colloquium
common: commons
concave: concave
contact: contact
convergence: convergence
convergent: convergent
copyright: copyright
creative: creative
customer: customer
da: das
declare: declare
define: define defined
department: department
detection: detection
di: di
difference: difference
disclaimer: disclaimer
editorial: editorial
education: education
equivalence: equivalence
equivalent: equivalent
ethic: ethics
exchange: exchange
faculty: faculty
fast: fast
file: file
fisher: fisher
follow: follow
free: free
freedman: freedman
frequently: frequently
function: function
generalization: generalization
guideline: guideline
health: health
history: history
home: home
ideal: ideal
index: indexing
interest: interest
international: international
issue: issue
japan: japan
journal: journal
la: la
lacunary: lacunary
library: library
license: license licensed
limit: limit
login: login
manuscript: manuscript
mathematical: mathematical
mathematics: mathematics
matrix: matrix
menu: menu
mi: mi
modulus: modulus
news: news
obtain: obtain
open: open
pacific: pacific
paper: paper
philosophical: philosophical
physic: physics
policy: policy
positive: positive
preservation: preservation
privacy: privacy
proofread: proofreading
pst: pst
psych: psych
publication: publication
pure: pure
real: real
receive: receive
recommend: recommend
related: related
research: research
reserve: reserved
respect: respect
retraction: retraction
ruckle: ruckle
salat: salat
sar: sar
scientific: scientific
scope: scope
select: select
sequence: sequence
service: service
share: share
society: society
soft: soft
special: special
statement: statement
statistical: statistical
statistically: statistically
strictly: strictly
strong: strong
strongly: strongly
study: study
subject: subject
submit: submit
subscription: subscription
summability: summability
summable: summable
sur: sur
system: system
ti: ti
top: top
translation: translation
turkey: turkey
university: university
us: us
van: van
volume: volume
wet: wet
work: work
ym: ym
