aa: aa
abb: abb
abbasi: abbasi
able: able
abnormality: abnormality
abstract: abstract
academic: academic
access: access
accumulation: accumulation
act: act
activity: activity
acute: acute
ad: ad
add: add
addition: addition
address: address
adequate: adequate
administer: administer
administration: administration
adverse: adverse
ae: ae
aer: aer
affect: affect
affected: affected
age: age aged
agriculture: agriculture
aid: aid
aim: aim
ait: ait
al: al
alert: alert
alpha: alpha
also: also
ambulatory: ambulatory
ami: ami
among: among
amount: amount
analysis: analysis
anil: anil
ann: ann
annals: annals
antidiabetic: antidiabetic
anxiety: anxiety
ape: ape
apnea: apnea
apply: applied
approach: approach
approval: approval
archive: archive
ariel: ariel
arousal: arousal
article: article
asleep: asleep
assessment: assessment
associate: associated
association: association
attribution: attribution
author: author
autoimmunity: autoimmunity
balance: balancing
basal: basal
base: based
bearing: bearing
becomes: becomes
benny: benny
biochemistry: biochemistry
biology: biology
blindness: blindness
blood: blood
board: board
body: body
breathing: breathing
calorie: calorie
capital: capital
cardiovascular: cardiovascular
care: care
causal: causal
cause: cause
ce: ce
cell: cell
center: center
central: central
channelize: channelize
characteristic: characteristic
chi: chi
chile: chile
chromatography: chromatography
chronic: chronic
cirrhosis: cirrhosis
cite: cite
classify: classified
clinical: clinical
cohort: cohort
college: college
committee: committee
common: commons
community: community
compare: compare
complex: complex
component: component
composite: composite
conclusion: conclusion
concurrent: concurrent
confirm: confirming
confound: confound
connection: connection
consider: considered
consistency: consistency
contact: contact
contribute: contribute
control: control
copyright: copyright
correlate: correlated
correlation: correlation
correspond: corresponding
counteract: counteract
country: country
course: course
creative: creative
cross: cross
current: current
customer: customer
data: data
day: day
daytime: daytime
de: de
death: death
declare: declare
define: defined
department: department
dependent: dependent
depressed: depressed
depression: depression
depressive: depressive
design: design designed
detection: detection
determine: determined
develop: develop
development: development
diabetes: diabetes
diabetic: diabetic
diet: diet
difference: difference
direct: direct directed
direction: direction
disclaimer: disclaimer
discussion: discussion
disease: disease
disorder: disorder
disruption: disruption
disturbance: disturbance
disturbed: disturbed
dosage: dosage
dramatically: dramatically
drive: drive
drug: drug
due: due
duration: duration
dynamic: dynamic
dysfunction: dysfunction
early: early
eat: eating
editorial: editorial
effect: effect
effectively: effectively
efficiency: efficiency
efficient: efficient
elderly: elderly
elevate: elevated
emergency: emergency
encyclopedia: encyclopedia
endocrinology: endocrinology
epidemiological: epidemiological
erratic: erratic
especially: especially
ethic: ethics
evaluate: evaluate
evaluation: evaluation
examine: examine
exert: exert
experience: experience
experimental: experimental
expression: expression
extend: extend
fact: fact
factor: factor
failure: failure
fall: falling
fast: fasting
feature: feature
female: female
file: file
five: five
follow: follow
form: form
found: found
fragment: fragmented
free: free
frequently: frequently
future: future
gen: gen
gender: gender
general: general
generate: generate
get: got
global: global
glucose: glucose
good: good
graduate: graduate
great: greater
grove: grove
guideline: guideline
habitual: habitual
haemoglobin: haemoglobin
headache: headache
health: health
healthy: healthy
heart: heart
hepatic: hepatic
high: high higher
history: history
holistic: holistic
home: home
hormone: hormone
however: however
human: human
hypertension: hypertension
hypoglycemia: hypoglycemia
hypoglycemic: hypoglycemic
id: id
impact: impact
important: important
include: include included
income: income
independent: independent
index: index indexing
individual: individual
infer: infer
influence: influence
insomnia: insomnia
institute: institute
institution: institution
instrument: instrument
insulin: insulin
integration: integration
interest: interest
internal: internal
international: international
interpretation: interpretation
interventional: interventional
interview: interview
introduction: introduction
investigate: investigate
involvement: involvement
issue: issue
journal: journal
keep: keeping
kidney: kidney
kim: kim
know: known
knowledge: knowledge
lag: lagged
latency: latency
lead: leading
least: least
lee: lee
less: less
level: level
ley: ley
li: li
library: library
license: license licensed
like: like
likely: likely
limitation: limitation
link: linked
lipoprotein: lipoprotein
liquid: liquid
login: login
logistic: logistic
longer: longer
loss: loss
low: low
machine: machine
major: major
majority: majority
malignant: malignant
manage: manage
management: management
manuscript: manuscript
many: many
mass: mass
may: may
mean: mean
measure: measure measured
measurement: measurement
mechanism: mechanism
medical: medical
medication: medication
medicine: medicine
mental: mental
menu: menu
metabolic: metabolic
metabolism: metabolism
mi: mi
might: might
monk: monk
month: month
mood: mood
morbid: morbid
morning: morning
mortality: mortality
narrower: narrower
nationwide: nationwide
nature: nature
need: need
new: new
news: news
nineteen: nineteen
nocturnal: nocturnal
note: noted
number: number
obesity: obesity
objective: objective
observation: observation
obstructive: obstructive
occur: occur
often: often
old: older
one: one
open: open
opinion: opinion
oral: oral
outcome: outcome
outpatient: outpatient
paper: paper
particularly: particularly
patient: patient
pattern: pattern
people: people
per: per
percentage: percentage
performance: performance
periodic: periodic
person: person
physical: physical
policy: policy
poor: poor
population: population
positive: positive
possible: possible
prabhu: prabhu
practice: practice
present: present
preservation: preservation
press: press
pressure: pressure
prevalence: prevalence
prevalent: prevalent
prevent: prevent
previous: previous
previously: previously
privacy: privacy
problem: problem
prognosis: prognosis
progress: progress
prone: prone
proofread: proofreading
prospective: prospective
prove: prove proved
pst: pst
psych: psych
psychiatria: psychiatria
psychiatric: psychiatric
psychiatry: psychiatry
psychological: psychological
public: public
publication: publication
quality: quality
quantitative: quantitative
questionnaire: questionnaire
rapid: rapid
rat: rat
rather: rather
reason: reason
receive: receive
recent: recent
receptor: receptor
recommend: recommend
record: record
regard: regard
regression: regression
relate: relate
related: related
relationship: relationship
remain: remain
repeatability: repeatability
replacement: replacement
representative: representative
research: research
reserve: reserved
resistance: resistance
respiratory: respiratory
response: response
responsible: responsible
retraction: retraction
reveal: reveal revealed
review: review
risk: risk
role: role
room: room
san: san
sar: sar
scale: scale scales
school: school
scientific: scientific
scope: scope
score: score scored
scrutiny: scrutiny
sectional: sectional
sector: sector
see: seen
select: select
sensitivity: sensitivity
separate: separate
sequela: sequelae
serious: serious
serum: serum
service: service
seven: seven
severe: severe
sex: sex
share: share
short: short
show: showing shown
significant: significant
significantly: significantly
similar: similar
since: since
singer: singer
sleep: sleep sleeping
sleepiness: sleepiness
small: small
smith: smith
soft: soft
song: song
special: special
spindle: spindle
square: square
statement: statement
statistic: statistics
statistical: statistical
statistically: statistically
still: still
strict: strict
study: studied study
subject: subject subjected
subjective: subjective
submit: submit
subscription: subscription
suggest: suggest
suicide: suicide
surgery: surgery
survey: survey
symptomatology: symptomatology
syndrome: syndrome
system: system
systematic: systematic
table: table
take: took
ten: ten
tend: tend
test: test
therapy: therapy
thus: thus
ti: ti
time: time
tool: tool
top: top
total: total
traditional: traditional
translate: translate
translation: translation
trauma: trauma
treatment: treatment
turn: turn
type: type
unable: unable
unfairly: unfairly
unipolar: unipolar
university: university
unknown: unknown
us: us
usage: usage
use: use used
useful: useful
validate: validate
valuable: valuable
value: value
variability: variability
variable: variable
variety: variety
various: various
ventilation: ventilation
vital: vital
vol: vol
volume: volume
vulnerable: vulnerable
walter: walter
wang: wang
weight: weight
wet: wet
white: white
work: work
world: world
ye: ye
ym: ym
young: young
