aa: aa
abb: abb
abstract: abstract
access: access
act: act
ad: ad
add: add
address: address
adjacent: adjacent
ae: ae
aer: aer
aid: aid
aim: aim
ait: ait
alert: alert
also: also
ami: ami
another: another
ape: ape
archive: archive
article: article
attribution: attribution
board: board
boston: boston
call: call
case: case
ce: ce
character: character
cite: cite
clear: clear
clearly: clearly
close: closed
collection: collection
college: college
common: commons
complex: complex
conclude: concluding
construct: construct
contact: contact
contain: contain
contradiction: contradiction
conversely: conversely
copyright: copyright
cover: covered
creative: creative
customer: customer
cycle: cycle
declare: declare
define: defined
definition: definition
denote: denote
derive: derive derived
detection: detection
disclaimer: disclaimer
discrete: discrete
domination: domination
e: es
edge: edge
editorial: editorial
either: either
en: en
engineering: engineering
equal: equal
ethic: ethics
every: every
expression: expression
family: family
file: file
first: first
follow: follow following
form: form
formula: formula
four: four
free: free
frequently: frequently
get: get
good: good
graph: graph
great: greater
guideline: guideline
health: health
hence: hence
history: history
hold: hold
home: home
hypothesis: hypothesis
id: id
identify: identify
important: important
incident: incident
index: indexing
induction: induction
initial: initial
integer: integer
interest: interest interesting
international: international
introduction: introduction
investigate: investigate
issue: issue
journal: journal
least: least
lemma: lemma
length: length
less: less
let: let
library: library
license: license licensed
login: login
main: main
manuscript: manuscript
mar: mar
mathematical: mathematical
mathematics: mathematics
memorial: memorial
menu: menu
method: method
mi: mi
minimum: minimum
mixed: mixed
multiple: multiple
must: must
natural: natural
need: need
news: news
next: next
number: number
obtain: obtain
one: one
open: open
order: order
organization: organization
paper: paper
part: part
path: path
policy: policy
polynomial: polynomial
possible: possible
preservation: preservation
privacy: privacy
proof: proof
proofread: proofreading
property: property
prove: prove proved
pst: pst
psych: psych
publication: publication
real: real
receive: receive
recommend: recommend
recursive: recursive
related: related
relation: relation
research: research
reserve: reserved
result: result
retraction: retraction
sar: sar
scientific: scientific
scope: scope
section: section
select: select
service: service
set: set
shall: shall
share: share
show: shown
similarly: similarly
simple: simple
simply: simply
since: since
size: size
soft: soft
special: special
split: split
square: square
statement: statement
statistic: statistics
study: studied
subject: subject
submit: submit
subscription: subscription
suppose: suppose
system: system
table: table
technology: technology
theorem: theorem
theory: theory
therefore: therefore
throughout: throughout
thus: thus
ti: ti
ting: ting
top: top
translation: translation
true: true
us: us
use: use
usual: usual
vertex: vertex vertices
volume: volume
wet: wet
whether: whether
work: work
write: write
ym: ym
