aa: aa
abb: abb
ability: ability
able: able
abstract: abstract
accept: accept
acceptance: acceptance
access: access
accessible: accessible
accomplishment: accomplishment
accord: according
accordance: accordance
account: account
accuracy: accuracy
accurately: accurately
act: act
activation: activation
actually: actually
ad: ad
adapt: adapt
add: add
adder: adder
addition: addition
additional: additional
address: address
adopt: adopt
advice: advice
ae: ae
aer: aer
agreement: agreement
ai: ai
aid: aid
aim: aim
ait: ait
alert: alert
algorithm: algorithm
also: also
alternative: alternative
although: although
ami: ami
among: among
analogy: analogy
analysis: analysis
ann: ann
another: another
ape: ape
appear: appear
append: append
application: application
apply: apply
approach: approach
appropriate: appropriate
approximate: approximate
arbitrarily: arbitrarily
architecture: architecture
archive: archive
arithmetic: arithmetic
arm: armed
arrangement: arrangement
array: array
article: article
artificial: artificial
assign: assigned
associate: associated
association: association
attach: attached
attend: attend
attributable: attributable
attribute: attribute
attribution: attribution
automatic: automatic
automatically: automatically
autonomous: autonomous
autonomy: autonomy
available: available
axon: axon
back: back
backward: backward
balance: balancing
base: based
basic: basic
beam: beam
become: become
behavior: behavior
belong: belong
belonging: belonging
ben: ben
best: best
bias: bias
biological: biological
biologically: biologically
biology: biology
black: black
block: block
board: board
body: body
bold: bold
born: born
boston: boston
bottom: bottom
box: box
brain: brain
bring: bring
building: building
built: built
calculate: calculate calculated
calculation: calculation
call: call
cancer: cancer
capable: capable
capacity: capacity
capital: capital
carry: carried carry
case: case
ce: ce
cell: cell
central: central
certain: certain
change: change
characterize: characterize
chosen: chosen
chronological: chronological
cite: cite
civil: civil
clarity: clarity
class: class
classic: classic
clear: clear
clearly: clearly
closely: closely
cluster: clustering
column: column
come: come comes
common: common commons
communication: communication
comparison: comparison
complete: complete
complex: complex
complexity: complexity
complicate: complicated
component: component
compose: composed
computational: computational
computer: computer
concede: concede
concept: concept
conceptual: conceptual
concern: concerning
concise: concise
conclude: conclude
concur: concur
concurrent: concurrent
conference: conference
connect: connected
connection: connection
connectivity: connectivity
consecutive: consecutive
consequently: consequently
consider: considered considering
consideration: consideration
constant: constant
constituent: constituent
constitute: constitute
contact: contact
continue: continue
contribute: contribute
conventional: conventional
copyright: copyright
correct: correct
correspond: corresponding
correspondence: correspondence
could: could
court: court
create: create
creation: creation
creative: creative
cross: cross
currently: currently
customer: customer
cut: cut
data: data
daughter: daughter
de: de
debatable: debatable
declare: declare
define: define defined
delivery: delivery
demand: demand
departure: departure
derivative: derivative
derive: derived
description: description
design: design designed designing
designer: designer
detection: detection
determination: determination
determine: determine determined
development: development
diagonal: diagonal
diagram: diagram
didactic: didactic
differ: differ
different: different
differentiation: differentiation
difficult: difficult
digital: digital
direct: direct
direction: direction
directly: directly
disappear: disappear
disclaimer: disclaimer
discrepancy: discrepancy
discriminate: discriminating
discus: discuss
discussion: discussion
displacement: displacement
distinguish: distinguishing
distribute: distributed
distribution: distribution
divide: divided
division: division
do: done
doctoral: doctoral
double: double
due: due
edge: edge
editorial: editorial
educational: educational
effective: effective
eight: eight
eighth: eighth
either: either
electronic: electronic
electronics: electronics
element: element
elemental: elemental
end: end
engineering: engineering
enough: enough
ensure: ensure
enter: entering
entire: entire
entrance: entrance
entry: entry
environment: environment
environmental: environmental
epidermis: epidermis
epithelium: epithelium
equal: equal
equilibrium: equilibrium
equitable: equitable
equivalence: equivalence
equivalent: equivalent
equivalently: equivalently
error: error
essential: essential
essentially: essentially
establish: establish established
estimate: estimate
ethic: ethics
even: even
event: event
eventually: eventually
everyone: everyone
evolution: evolution
evolutionary: evolutionary
example: example
except: except
exception: exception
excitatory: excitatory
excite: excite
execute: executed
execution: execution
exist: exist
expansion: expansion
express: expressed
external: external
extract: extract extracted
extreme: extreme
extremely: extremely
face: face
facilitate: facilitate
fact: fact
factor: factor
fair: fair
fairly: fairly
family: family
far: far
fashion: fashion
fasten: fastening
fault: fault
feature: feature
fed: fed
feed: feed
feedback: feedback
fi: fi
field: field
figure: figure
file: file
final: final
finally: finally
finite: finite
first: first
firstly: firstly
five: five
fix: fixed
flat: flat
flexibility: flexibility
follow: follow following
forget: forget
form: form formed
formula: formula
formulation: formulation
forward: forward
found: found
four: four
fourth: fourth
frame: frame
framework: framework
free: free
frequently: frequently
function: function
functional: functional
gantry: gantry
general: general
generally: generally
generate: generate
genetic: genetic
genetically: genetically
get: get
give: give given giving
go: go goes
goal: goal
graduate: graduate
grant: grant
group: group
growth: growth
guideline: guideline
handbook: handbook
hardware: hardware
hardy: hardy
health: health
hidden: hidden
high: high
highly: highly
history: history
home: home
horizontal: horizontal
however: however
human: human
hybrid: hybrid
identical: identical
ie: ie
illustrate: illustrate
illustration: illustration
immediately: immediately
implementation: implementation
important: important
impressive: impressive
improve: improve
income: income
incorporate: incorporate
increase: increase
independent: independent
indeterminate: indeterminate
index: indexing
individual: individual
induced: induced
inflow: inflow
information: information
inherent: inherent
inhibit: inhibit
inhibitory: inhibitory
input: input
inspiration: inspiration
inspire: inspire inspired inspiring
intelligence: intelligence
intelligent: intelligent
intend: intend
interaction: interaction
interest: interest
internal: internal
international: international
intestinal: intestinal
introduce: introduce
introduction: introduction
invention: invention
isolated: isolated
isolation: isolation
issue: issue
iteration: iteration
iterative: iterative
joint: joint
journal: journal
keep: keeping
key: key
knack: knack
knot: knot
know: know known
la: la
large: large
last: last
later: later
lateral: lateral
latter: latter
lattice: lattice
layer: layer
lead: lead leading led
learn: learn learning
least: least
left: left
let: let
level: level
library: library
license: license licensed
life: life
like: like
limited: limited
lineal: lineal
linear: linear
link: link linked links
little: little
lo: lo
load: loaded
local: local
locally: locally
logic: logic
logically: logically
login: login
long: long
look: look looking
macro: macro
main: main
mainly: mainly
make: make
man: man
manner: manner
manufacture: manufacture
manuscript: manuscript
many: many
mark: mark
massive: massive
massively: massively
material: material
mathematical: mathematical
matrix: matrices matrix
may: may
mean: mean
mechanical: mechanical
mechanism: mechanism
medium: media
meet: meet
meeting: meeting
member: member
memory: memory
menu: menu
met: met
method: method
mi: mi
might: might
mitosis: mitosis
mitotic: mitotic
model: model
moment: moment
monitor: monitor
mother: mother
much: much
multiple: multiple
multiplication: multiplication
multiply: multiply
must: must
namely: namely
natural: natural
nature: nature
near: near
necessary: necessary
need: need needs
nervous: nervous
net: net
network: network
neural: neural
neuron: neuron
neuronal: neuronal
new: new
news: news
next: next
nexus: nexus
node: node
notation: notation
note: note noted
number: number
numerical: numerical
object: object
objective: objective
observe: observe
obtain: obtain
one: one
open: open
operate: operate
operating: operating
operation: operation
operatively: operatively
opposite: opposite
order: order
organization: organization
organize: organized
original: original
output: output
outside: outside
overview: overview
paper: paper
parallel: parallel
parallelism: parallelism
parenthesis: parentheses
part: part
particular: particular
partition: partitioning
pas: pass
pattern: pattern
penultimate: penultimate
per: per
perfect: perfect
perform: perform
performance: performance
phenomenon: phenomenon
physical: physical
physiological: physiological
pinto: pinto
place: place
plane: plane
plausibility: plausibility
plus: plus
policy: policy
porch: porch
portal: portal
positive: positive
possible: possible
possibly: possibly
power: power
practical: practical
precedent: precedent
precisely: precisely
prediction: prediction
predominantly: predominantly
preliminary: preliminary
presence: presence
present: present
presentation: presentation
preservation: preservation
press: press
previous: previous
primitive: primitive
print: printed
prior: prior
privacy: privacy
problem: problem
procedure: procedure
proceed: proceeding
process: process
produce: produce produced
product: product
program: program
proofread: proofreading
property: property
proposal: proposal
proven: proven
pst: pst
psych: psych
publication: publication
pulse: pulse
put: put
question: question
quickly: quickly
quite: quite
rather: rather
ratio: ratio
react: react
real: real
realize: realize
receive: receive
recommend: recommend
record: recording
recurrent: recurrent
refer: refer
reference: reference
registration: registration
related: related
relationship: relationship
relatively: relatively
remain: remain
remains: remains
removal: removal
remove: removed removing
repeat: repeat
require: require
research: research
reserve: reserved
respective: respective
respectively: respectively
response: response
result: result resulting
retraction: retraction
right: right
rightmost: rightmost
rise: rise
robust: robust
rotation: rotation
rotational: rotational
row: row
run: run running
sake: sake
sar: sar
say: say
scalar: scalar
scenario: scenario
scheme: scheme
scientific: scientific
scope: scope
second: second
secondly: secondly
see: see seen
select: select
sent: sent
separately: separately
sequence: sequence
sequential: sequential
sequentially: sequentially
serial: serial
series: series
serve: serve
service: service
set: set
seven: seven
several: several
share: share
shear: shear
shed: shed
show: show shown
si: sis
signal: signal
significantly: significantly
similar: similar
similarity: similarity
simple: simple
simpler: simpler
simplification: simplification
simplify: simplified
simply: simply
simulate: simulate
simulation: simulation
since: since
single: single
small: small
society: society
soft: soft
solution: solution
solve: solve
sometimes: sometimes
source: source
special: special
specific: specific
speed: speed
stage: stage
standard: standard
start: starting
statement: statement
static: static
statically: statically
stem: stem
stiffness: stiffness
still: still
stimulate: stimulate
stimulus: stimuli
stop: stopped
storage: storage
strength: strength
strictly: strictly
strongly: strongly
structural: structural
structure: structure
student: student
study: studied study
sub: sub
subject: subject
submit: submit
subscription: subscription
subsequent: subsequent
successive: successive
successively: successively
suffer: suffering
sufficient: sufficient
suitable: suitable
sum: sum summed
summation: summation
summer: summer
superscript: superscript
supervisor: supervisor
support: support
switch: switching
synapse: synapse
synthesis: synthesis
system: system
systematic: systematic
systematically: systematically
table: table
take: taken taking
target: target
teach: teaching
tendency: tendency
terminology: terminology
text: text
thanks: thanks
theoretical: theoretical
theory: theory
therefore: therefore
think: think
third: third
though: though
three: three
threshold: threshold
thus: thus
ti: ti
time: time
together: together
tolerance: tolerance
tolerant: tolerant
tool: tool
toolbox: toolbox
top: top topping
topology: topology
total: total
traditional: traditional
train: trained
training: training
transcendental: transcendental
transfer: transfer transferred
transformation: transformation
translation: translation
transmit: transmit
trend: trend
two: two
type: type
typical: typical
typically: typically
understand: understand
unidirectional: unidirectional
unit: unit
unlabeled: unlabeled
unless: unless
unlimited: unlimited
unsupervised: unsupervised
urgent: urgent
us: us
use: use used
useful: useful
validity: validity
value: value
variety: variety
various: various
vector: vector
verification: verification
vertebrate: vertebrate
viable: viable
volume: volume
want: want
way: way
weight: weight weighted weighting
well: better well
wet: wet
wherein: wherein
whit: whit
whole: whole
whose: whose
without: without
work: work
world: world
worry: worry
would: would
write: write written
yes: yes
yet: yet
ym: ym
