aa: aa
abb: abb
able: able
abstract: abstract
access: access
accord: according
accuracy: accuracy
acquisition: acquisition
act: act
ad: ad
adaptation: adaptation
add: add added
address: address
adjust: adjust
adjustable: adjustable
adjustment: adjustment
adopt: adopted
ae: ae
aer: aer
age: age
aggregate: aggregate
aid: aid
aim: aim
ait: ait
al: al
alert: alert
allow: allow
already: already
also: also
ami: ami
among: among
amount: amount
analysis: analyses analysis
analytical: analytical
analytically: analytically
answer: answer
ape: ape
application: application
apply: applied apply
approach: approach
approximate: approximate
approximation: approximation
archive: archive
arose: arose
around: around
article: article
ascend: ascending
assess: assessed
associate: associated
assume: assumed
asymptote: asymptote
asymptotic: asymptotic
attribution: attribution
author: author
available: available
average: average
axial: axial
band: band
bar: bar
barcelona: barcelona
barra: barra
base: based
basis: basis
beam: beam
begin: begin beginning
behavior: behavior
behaviour: behaviour
best: best
big: big bigger
board: board
bond: bond
branch: branch
brazil: brazil
brick: brick
broad: broad
build: build
building: building
built: built
calculate: calculated
cape: capes
carry: carried
case: case
ce: ce
cement: cement
central: central
cess: cess
challenge: challenge
chemical: chemical
china: china
choice: choice
chosen: chosen
cite: cite
civil: civil
close: close
coarse: coarse
code: code
coefficient: coefficient
coherent: coherent
committee: committee
common: commons
comparison: comparison
complete: complete
compose: composed
composition: composition
compression: compression
compressive: compressive
conclude: conclude
concrete: concrete
conditioner: conditioner
conference: conference
configuration: configuration
confirm: confirmed
consequence: consequence
consider: considered considering
considerably: considerably
consistent: consistent
constitutive: constitutive
construction: construction
contact: contact
content: content contents
continuous: continuous
contribution: contribution
control: control
conventional: conventional
copyright: copyright
correspond: corresponding
could: could
couple: coupled
crack: crack cracking
creative: creative
criterion: criteria
crush: crushed
cure: cure
curve: curve
customer: customer
cylindrical: cylindrical
da: da
damage: damage
data: data
day: days
de: de
declare: declare
define: defined
definition: definition
deformation: deformation
degradation: degradation
delicate: delicate
demolition: demolition
depend: depending
descend: descending
describe: describe
description: description
design: design designing
despite: despite
detection: detection
determination: determination
development: development
diameter: diameter
different: different
direct: direct
direction: direction
directly: directly
disclaimer: disclaimer
discrete: discrete
discussion: discussion
displacement: displacement
dissertation: dissertation
distribute: distributed
do: done
domain: domain
draw: draw
drawn: drawn
drop: drop
due: due
editorial: editorial
efficiency: efficiency
eight: eight
elasticity: elasticity
element: element
energy: energy
engineering: engineering
environment: environment
environmental: environmental
equal: equal
equation: equation
equivalent: equivalent
err: err
error: error
establish: establish established
ethic: ethics
evaluation: evaluation
even: even
exactly: exactly
example: example
existence: existence
experimental: experimental
experimentally: experimentally
explicit: explicit
exponential: exponential
express: express expressed
expression: expression
extreme: extreme
fatigue: fatigue
field: field
figure: figure
file: file
financial: financial
fine: fine
finite: finite
flexion: flexion
flexural: flexural
follow: follow following
form: form
formulation: formulation
found: found
fracture: fracture
free: free
frequently: frequently
fulfill: fulfill
function: function
fundamental: fundamental
furthermore: furthermore
general: general
generalization: generalization
generalize: generalized
geometry: geometry
german: german
get: get
give: given
global: global
goal: goal
good: good
graphically: graphically
gravimetric: gravimetric
great: great greater
guide: guide
guideline: guideline
hamper: hamper
health: health
height: height
heterogeneity: heterogeneity
high: high higher
history: history
home: home
horizontal: horizontal
housing: housing
however: however
hydraulic: hydraulic
hypothesis: hypothesis
identification: identification
impact: impact
implicitly: implicitly
importance: importance
important: important
include: included
incorporate: incorporate
increase: increase
independent: independent
index: indexing
individually: individually
inferior: inferior
influence: influence
inherent: inherent
initial: initial
institute: institute
interest: interest
interfere: interfere
international: international
interval: interval
introduction: introduction
investigation: investigation
isotropic: isotropic
issue: issue
item: item
iterative: iterative
journal: journal
laboratory: laboratory
lack: lack
lateral: lateral
latter: latter
least: least
li: li
library: library
license: license licensed
lie: lie
like: like
limit: limit
lin: lin
linear: linear
list: listed
load: load loading
login: login
longitudinal: longitudinal
low: lower
machine: machine
main: main
mainly: mainly
major: major
make: make making
manipulation: manipulation
manuscript: manuscript
material: material
mathematical: mathematical
maximum: maximum
mechanic: mechanic mechanics
mechanical: mechanical
menu: menu
method: method
methodology: methodology
mi: mi
ministry: ministry
mixture: mixture
model: model modeling
modulus: modulus
monograph: monograph
mortar: mortar
must: must
national: national
natural: natural
necessarily: necessarily
necessary: necessary
need: need needs
negative: negative
news: news
non: non
note: note
number: number
numerical: numerical
observation: observation
observe: observe observing
obtain: obtain
obtainment: obtainment
occur: occur
one: one
open: open
order: order
original: original
originally: originally
paper: paper
parameter: parameter
parametric: parametric
part: part
pas: pass
peak: peak
performance: performance
phase: phases
phenomenon: phenomena
physical: physical
plasticity: plasticity
point: point
policy: policy
polynomial: polynomial
poon: poon
porosity: porosity
positive: positive
possible: possible
prediction: prediction
present: present
presentation: presentation
preservation: preservation
press: press
previously: previously
privacy: privacy
proceed: proceeding
processor: processor
produce: produced
production: production
professor: professor
program: program
progress: progress
progression: progression
proofread: proofreading
proportional: proportional
propose: propose
provide: provide
proximity: proximity
pst: pst
psych: psych
publication: publication
quadratic: quadratic
quality: quality
rate: rate
ratio: ratio
real: real reis
receive: receive
recent: recent
recommend: recommend
reduce: reduced
ref: ref
reference: reference
regard: regarding
regression: regression
reinforcement: reinforcement
related: related
relation: relation
relationship: relationship
reliability: reliability
remainder: remainder
replacement: replacement
represent: represent
representative: representative
research: research
reserve: reserved
respective: respective
respectively: respectively
result: result resulting
retraction: retraction
review: review
rio: rio
rupture: rupture
sample: sample
sar: sar
satisfactorily: satisfactorily
satisfactory: satisfactory
schematically: schematically
science: science
scientific: scientific
scope: scope
second: second
section: section
see: seen
select: select
sense: sense
sensitive: sensitive
service: service
shape: shape
share: share
show: show shown
silva: silva
similar: similar
single: single
six: six
size: size
slope: slope
small: smaller
soft: soft
solution: solution
space: spacing
special: special
specific: specific
split: split
square: square
standard: standard
state: state
statement: statement
steel: steel
still: still
strength: strength
stress: stress
structural: structural
structure: structure
study: studied study
subject: subject
submit: submit
subscription: subscription
substitute: substituted substituting
substitution: substitution
supplementary: supplementary
support: support
surface: surface
sustainable: sustainable
system: system
table: table
technological: technological
telford: telford
tensile: tensile
tension: tension
test: test
thank: thank
theoretical: theoretical
theory: theory
thereby: thereby
therefore: therefore
thesis: thesis
three: three
thus: thus
ti: ti
time: time
top: top
total: total
transition: transition
translation: translation
two: two
type: type
understand: understanding
uniaxial: uniaxial
university: university
upon: upon
us: us
use: use used
user: user
utilization: utilization
validation: validation
value: value
variability: variability
variable: variable
variation: variation
versus: versus
view: view
volume: volume
wang: wang
waste: waste
way: way
weight: weight
well: well
wet: wet
width: width
work: work
write: written
xi: xi
ym: ym
zone: zone
