aa: aa
abb: abb
able: able
abnormal: abnormal
abstract: abstract
academic: academic
academy: academy
accept: accept
access: access
act: act
actually: actually
ad: ad
add: add added
addition: addition
additional: additional
additive: additive
address: address
adjoint: adjoint
admissible: admissible
ae: ae
aer: aer
aid: aid
aim: aim
ait: ait
alert: alert
allow: allow
also: also
alternative: alternative
always: always
ami: ami
analogous: analogous
analysis: analysis
another: another
ape: ape
appear: appear
appendix: appendix
application: application
apply: applied apply
approximate: approximate
arbitrarily: arbitrarily
arbitrary: arbitrary
archive: archive
argument: argument
arisen: arisen
article: article
assume: assume assumed assuming
assumption: assumption
atle: atle
attribution: attribution
automatic: automatic
automatically: automatically
auxiliary: auxiliary
avoid: avoid
back: back
basic: basic
basis: basis
becomes: becomes
begin: beginning
belong: belong
bine: bine
board: board
body: body
boston: boston
bound: bounded
boundedness: boundedness
call: call
carry: carried
case: case
ce: ce
certain: certain
change: change
choose: choose
chosen: chosen
cite: cite
class: class
close: close closed
cluster: cluster
collection: collection
combination: combination
combine: combine combined combining
common: common commons
compact: compact
compactness: compactness
compare: compare
complete: complete
completely: completely
concave: concave
concern: concerning
conclusion: conclusion
condition: condition
conference: conference
connect: connected
connection: connection
consider: consider
consist: consist
constant: constant
constrain: constrained
constraint: constraint
construct: construct
construction: construction
consult: consult
contact: contact
continuity: continuity
continuous: continuous
contradiction: contradiction
control: control
controllability: controllability
convenient: convenient
converge: converging
convergence: convergence
convergent: convergent
convex: convex
copyright: copyright
correct: correct
correspond: corresponding
countable: countable
course: course
creative: creative
criterion: criterion
customer: customer
danger: danger
de: de
declare: declare
decrease: decreasing
deeply: deeply
define: define defined
definition: definition
degeneracy: degeneracy
degenerate: degenerate
demand: demanding
dense: dense
dependent: dependent
derivative: derivative
derive: derive
detailed: detailed
detection: detection
determine: determine
differ: differ
differentiable: differentiable
differential: differential
disclaimer: disclaimer
discount: discount
disjoint: disjoint
divide: dividing
do: done
dominant: dominant
dominate: dominated
double: double
doubly: doubly
duality: duality
due: due
dynamic: dynamic dynamics
early: early
easily: easily
economic: economic
economics: economics
editorial: editorial
either: either
element: element
elsewhere: elsewhere
empty: empty
end: end
enough: enough
entity: entity
equal: equal
equality: equality
equation: equation
especial: especial
essentially: essentially
establishment: establishment
ethic: ethics
even: even
evidently: evidently
exact: exact
exactly: exactly
example: example
exist: exist
existence: existence
exposition: exposition
expression: expression
extend: extend
extract: extract
fact: fact
fail: fail
family: family
far: far
faro: faro
feasible: feasible
file: file
finally: finally
finite: finite
finitely: finitely
first: first
fix: fix fixed
follow: follow following
form: form
former: former
formula: formula
free: free
frequently: frequently
full: full
function: function
functional: functional
furnish: furnished
furthermore: furthermore
general: general
generalize: generalized
get: get getting
give: give given
go: going
good: good
grateful: grateful
growth: growth
guideline: guideline
hand: hand
health: health
helpful: helpful
hence: hence
history: history
hold: hold holding
home: home
horizon: horizon
however: however
identity: identity
illustrate: illustrate
imply: imply
impossible: impossible
improve: improve
include: include
inclusion: inclusion
increase: increasing
independent: independent
index: index indexing indices
indexed: indexed
inductively: inductively
inequality: inequality
infinite: infinite
infinity: infinity
information: information
informative: informative
initial: initial
instead: instead
institute: institute
insufficient: insufficient
integrable: integrable
interest: interest
international: international
intersection: intersection
interval: interval
introduce: introduce
introduction: introduction
investigation: investigation
issue: issue
jointly: jointly
journal: journal
june: june
keep: keep
know: know
large: large
last: last
later: later
latter: latter
lead: lead
least: least
left: left
lemma: lemma
let: let
library: library
license: license licensed
like: like
limit: limit
limited: limited
linear: linear
linearly: linearly
local: local
locally: locally
login: login
main: main
make: made make
manner: manner
manuscript: manuscript
many: many
map: map
mathematical: mathematical
mathematics: mathematics
matrix: matrices matrix
maximize: maximize
maximum: maximum
may: may
measurable: measurable
measure: measure
menu: menu
mi: mi
might: might
modification: modification
moment: moment
moreover: moreover
much: much
mum: mum
must: must
name: name
namely: namely
narrow: narrow
natural: natural
near: near
necessary: necessary
necessity: necessity
need: need
needle: needle
negative: negative
new: new
news: news
next: next
nobody: nobody
nondegenerate: nondegenerate
nonlinear: nonlinear
nonzero: nonzero
normality: normality
normalization: normalization
notation: notation
note: note
nothing: nothing
novelty: novelty
null: null
number: number
objective: objective
observation: observation
obtain: obtain
obvious: obvious
occur: occur
often: often
one: one
open: open
opposite: opposite
optimal: optimal
optimization: optimization
order: order ordered
original: original
otherwise: otherwise
outline: outline
overview: overview
pair: pair
paper: paper
particular: particular
partition: partition
pereira: pereira
perhaps: perhaps
perturbation: perturbation
perturbed: perturbed
phase: phase
phenomenon: phenomenon
piecewise: piecewise
point: point
policy: policy
positive: positive
possibility: possibility
possible: possible
possibly: possibly
postulate: postulate
precede: preceding
precisely: precisely
preferably: preferably
present: present
presentation: presentation
preservation: preservation
previous: previous
principle: principle
privacy: privacy
problem: problem
proof: proof
proofread: proofreading
property: property
proposal: proposal
prove: prove proved
provide: provided
pst: pst
psych: psych
publication: publication
put: put
quadruple: quadruple
rank: rank
rather: rather
reason: reason
recall: recall
receive: receive
recommend: recommend
regard: regarding
related: related
remark: remark
replace: replace
report: report
require: require
research: research
reserve: reserved
resolvent: resolvent
respectively: respectively
restrict: restricted
result: result
retraction: retraction
review: review
right: right
rise: rise
rough: rough
roughly: roughly
row: row
sar: sar
satisfaction: satisfaction
satisfied: satisfied
satisfy: satisfy satisfying
save: save
say: said say
scientific: scientific
scope: scope
second: second
section: section
secure: secure
see: see seen
segment: segment
select: select
separate: separate separating
separation: separation
sequel: sequel
sequence: sequence
service: service
set: set
several: several
shall: shall
share: share
short: short
show: show shown
side: side
silva: silva
similar: similar
similarly: similarly
simplicity: simplicity
simplify: simplify
single: single
situation: situation
slightly: slightly
small: small smaller
smooth: smooth
smoothness: smoothness
soft: soft
solution: solution
sometimes: sometimes
space: space
speak: speaking
special: special
specific: specific
square: square
standard: standard
state: state
statement: statement
still: still
strengthen: strengthening
strictly: strictly
strong: strong
structure: structure
subcase: subcase
subject: subject
submit: submit
subscription: subscription
subsequence: subsequence
subsequent: subsequent
subset: subset
sum: sum
support: support
surely: surely
surprise: surprise
system: system
take: taking
technology: technology
term: term
terminal: terminal
th: th
theorem: theorem
theory: theory
three: three
throughout: throughout
thus: thus
ti: ti
time: time
together: together
top: top
topology: topology
traditional: traditional
trajectory: trajectory
translation: translation
transversality: transversality
treatment: treatment
trivial: trivial
two: two
type: type
unbounded: unbounded
uniformly: uniformly
unilateral: unilateral
unique: unique
university: university
unless: unless
upon: upon
us: us
use: use used
useful: useful
usefulness: usefulness
vacuously: vacuously
valid: valid
vanish: vanishing
variable: variable
various: various
vector: vector
version: version
volume: volume
want: want
way: way
weak: weak
weaken: weaken weakening
weber: weber
weight: weight
well: better well
wet: wet
whenever: whenever
whether: whether
without: without
work: work works
would: would
write: write written
yet: yet
yield: yield
ym: ym
zero: zero
