aa: aa
abb: abb
abstract: abstract
acceptable: acceptable
accepted: accepted
access: access
accord: according
accordance: accordance
act: act
action: action
ad: ad
add: add added
address: address
ae: ae
aer: aer
aid: aid
aim: aim
ait: ait
al: al
alert: alert
already: already
also: also
ami: ami
among: among
analysis: analysis
angular: angular
ape: ape
applicable: applicable
apply: apply
approach: approach
approximation: approximation
archive: archive
arise: arise
article: article
associate: associated
assumption: assumption
attract: attract
attribution: attribution
author: author
available: available
average: average
axisymmetric: axisymmetric
back: back
basic: basic
basis: basis
become: become
becomes: becomes
behave: behave
behaviour: behaviour
beyond: beyond
bo: bo
board: board
book: book
boston: boston
bottom: bottom
bound: bound
brace: brace
break: breaking
built: built
carry: carry
case: case
ce: ce
cern: cern
characteristic: characteristic
charge: charge
cite: cite
clarendon: clarendon
close: close
combine: combined
come: come comes
common: commons
company: company
complementary: complementary
component: component
composite: composite
concept: concept
conceptually: conceptually
concern: concerning
conclude: concluding
condense: condensed
condition: condition
configuration: configuration
confirm: confirmed
confirmation: confirmation
connection: connection
consequently: consequently
consider: considered
consideration: consideration
consistency: consistency
constant: constant
contact: contact
conventional: conventional
convergent: convergent
convert: convert
copyright: copyright
correct: correct
correspond: corresponding
could: could
creative: creative
current: current
customer: customer
cylindrical: cylindrical
decimal: decimal
declare: declare
define: defined
density: density
dependence: dependence
derive: derived
detailed: detailed
detection: detection
dimension: dimension
dimensionless: dimensionless
direct: directed
direction: direction
disappear: disappear
disclaimer: disclaimer
discover: discovered
discussion: discussion
dispersion: dispersion
dive: dive
divergence: divergence
divergent: divergent
do: done
due: due
edition: edition
editorial: editorial
effect: effect effects
electric: electric
electrodynamic: electrodynamic
electrodynamical: electrodynamical
electrodynamics: electrodynamics
electromagnetic: electromagnetic
electron: electron
electrostatic: electrostatic
elementary: elementary
elucidate: elucidate
empty: empty
energy: energy
ensemble: ensemble
equal: equal
equally: equally
equation: equation
equilibrium: equilibrium
equivalent: equivalent
ethic: ethics
even: even
example: example
exist: exist
existence: existence
expectation: expectation
expense: expense
experience: experience
experimental: experimental
experimentally: experimentally
explicit: explicit
extend: extended
extension: extension
extra: extra
extremely: extremely
fact: fact
factor: factor
far: far
feature: feature
field: field
figuration: figuration
file: file
final: final
finally: finally
finite: finite
first: first
flux: flux
follow: follow following
force: force
form: form formed
foundation: foundation
frame: frame
free: free
freedom: freedom
frequency: frequency
frequently: frequently
function: function
fundamental: fundamental
future: future
gauge: gauge
general: general
generally: generally
generate: generating
geometry: geometry
give: given
govern: governing
group: group
guideline: guideline
handle: handling
hardly: hardly
harmonic: harmonic
health: health
hidden: hidden
highly: highly
history: history
home: home
however: however
hypothesis: hypothesis
important: important
impose: impose imposing
include: include included
index: indexing
individual: individual
infinite: infinite
instead: instead
institute: institute
integration: integration
interaction: interaction
interest: interest
international: international
interpretation: interpretation
intrinsic: intrinsic
introduce: introduce
introduction: introduction
invariance: invariance
involve: involved
issue: issue
journal: journal
laboratory: laboratory
large: large
lation: lation
latter: latter
lead: lead leading
least: least
length: length
library: library
license: license licensed
light: light
like: like
likely: likely
limit: limit
limited: limited
line: line
local: local
login: login
macroscopic: macroscopic
magnetic: magnetic
magnitude: magnitude
main: main
make: make making
manuscript: manuscript
mass: mass
maxwell: maxwell
may: may
mechanic: mechanics
member: member
menu: menu
merely: merely
metal: metal
mi: mi
minimum: minimum
model: model
modern: modern
modulus: modulus
moment: moment
momentum: momentum
monograph: monograph
narrow: narrow
nature: nature
necessary: necessary
need: need
needle: needle
net: net
neutral: neutral
new: new
news: news
ninth: ninth
nonzero: nonzero
normal: normal
note: noted
notice: notice
nova: nova
number: number
one: one
open: open
opposite: opposite
order: order
oscillator: oscillator
outset: outset
overcome: overcome
packet: packet
paper: paper
part: part
particle: particle
per: per
percent: percent
perhaps: perhaps
permit: permit
phase: phase
photoelectric: photoelectric
photon: photon
physic: physics
physical: physical
physically: physically
plane: plane
plasma: plasma
plausible: plausible
point: point pointed
polar: polar
policy: policy
possess: possessing
possible: possible
present: present
preservation: preservation
preserve: preserve
press: press
pressure: pressure
principle: principle
privacy: privacy
probability: probability
probable: probable
problem: problem
procedure: procedure
process: process
product: product
profile: profile
progress: progress
proofread: proofreading
propagation: propagation
proper: proper
property: property
pst: pst
psych: psych
publication: publication
purely: purely
purpose: purpose
quantization: quantization
quantum: quantum
radial: radial
radiation: radiation
radius: radius
range: range
ratio: ratio
real: real
receive: receive
recommend: recommend
reconcilable: reconcilable
reduction: reduction
related: related
relativistic: relativistic
relativity: relativity
relevant: relevant
remains: remains
remove: removed removing
represent: represent
require: require
research: research
reserve: reserved
rest: rest
restrict: restricted
result: result resulting
retraction: retraction
review: review
royal: royal
san: san
sar: sar
satisfy: satisfy
scalar: scalar
science: science
scientific: scientific
scope: scope
search: searching
section: section
select: select
separable: separable
separate: separate
service: service
several: several
shall: shall
shape: shape
share: share
show: show shown
side: side
simplification: simplification
since: since
single: single
slight: slight
small: small
soft: soft
solution: solution
somewhat: somewhat
source: source
space: space
spatial: spatial
spatially: spatially
special: special
spectrum: spectrum
spherical: spherical
spin: spin
stage: stage
standard: standard
start: starting
state: state stated
statement: statement
statistical: statistical
steady: steady
still: still
strong: strong
subject: subject
submit: submit
subscription: subscription
sufficiently: sufficiently
suitable: suitable
superimpose: superimposed
support: support
symmetric: symmetric
symmetry: symmetry
system: system
take: taken
technology: technology
temperature: temperature
tenth: tenth
term: term
theoretical: theoretical
theory: theory
thereby: thereby
therefore: therefore
third: third
thrown: thrown
thus: thus
ti: ti
time: time
together: together
top: top
total: total
towards: towards
translation: translation
transverse: transverse
treat: treating
treatment: treatment
truly: truly
truth: truth
turn: turn
turner: turner
two: two
unacceptable: unacceptable
uncertainty: uncertainty
undamped: undamped
underlie: underlying
understand: understanding
unification: unification
unity: unity
universe: universe
university: university
unobserved: unobserved
unspecified: unspecified
unstable: unstable
upon: upon
us: us
use: used
vacuum: vacuum
value: value
vanish: vanish vanishing
variable: variable
variation: variation
variational: variational
vector: vector
velocity: velocity
view: view
volume: volume
wave: wave
way: way
well: well
wet: wet
whereas: whereas
width: width
within: within
without: without
work: work
yet: yet
ym: ym
york: york
zero: zero
