aa: aa
abb: abb
abruptly: abruptly
absence: absence
absent: absent
absorption: absorption
abstract: abstract
abundance: abundance
abundant: abundant
academic: academic
access: access
accord: according
accordance: accordance
accumulation: accumulation
acetate: acetate
acid: acid
acidic: acidic
acidity: acidity
acidophilic: acidophilic
acquire: acquire
act: act
active: active
ad: ad
add: add
additional: additional
address: address
adjacent: adjacent
administrative: administrative
ae: ae
aer: aer
affect: affecting
aid: aid
aim: aim
air: air
ait: ait
al: al
alert: alert
algae: algae
algal: algal
algological: algological
alkaline: alkaline
alkalization: alkalization
alpine: alpine
also: also
altitude: altitude
ami: ami
ammonium: ammonium
among: among
analysis: analysis
anionic: anionic
annual: annual
anthropogenic: anthropogenic
ape: ape
appearance: appearance
approach: approach
archangel: archangel
archive: archive
area: area
arrive: arrive
article: article
artificial: artificial
assess: assess assessed
atlas: atlas
atomic: atomic
atomization: atomization
attribution: attribution
author: author
available: available
bacterial: bacterial
base: based
basic: basic
basidiomycete: basidiomycete
basis: basis
become: become
berlin: berlin
best: best
beyond: beyond
biogeography: biogeography
biological: biological
biology: biology
bipartition: bipartition
block: block
board: board
bold: bold
buffer: buffer
bulletin: bulletin
bus: bus
calculate: calculated
capital: capital
cationic: cationic
cause: cause
ce: ce
center: center
central: central
characteristic: characteristic
characterization: characterization
characterize: characterize
chemical: chemical
chromatograph: chromatograph
chronic: chronic
cite: cite
city: city
class: class classes
classification: classification
climate: climate
close: closed
coefficient: coefficient
cold: cold
color: colored
colorimetric: colorimetric
colorless: colorless
common: common commons
communal: communal
compact: compact
comparison: comparison
complementary: complementary
complex: complex
compose: composed
composition: composition
comprehensively: comprehensively
concentration: concentration
confirm: confirmed
conformity: conformity
contact: contact
contain: contain
contamination: contamination
contemporary: contemporary
content: content contents
continental: continental
contrary: contrary
control: control
conventional: conventional
copper: copper
copyright: copyright
correspond: corresponding
cover: cover
creative: creative
criterion: criteria
critical: critical
customer: customer
daily: daily
data: data
day: days
daylight: daylight
de: de
deal: deal
declare: declare
decrease: decrease decreasing
degree: degree
denote: denote
department: department
depend: depend depending
dependent: dependent
depth: depth
detection: detection
determine: determine determined
develop: develop
diagnostics: diagnostics
diatom: diatom
differ: differ
different: different
differently: differently
disclaimer: disclaimer
discus: discuss
discussion: discussion
dissertation: dissertation
distil: distilled
distribution: distribution
district: district
disturbed: disturbed
diversity: diversity
domestic: domestic
dominant: dominant
dominate: dominate
domination: domination
due: due
dynamic: dynamics
east: east
eastern: eastern
ecological: ecological
ecology: ecology
ecosystem: ecosystem
editorial: editorial
effect: effect
electrothermal: electrothermal
element: element
ellipsis: ellipses
environment: environment
environmental: environmental
equation: equation
especially: especially
estimate: estimate
ethic: ethics
even: even
every: every
example: example
exceed: exceed
exchangeable: exchangeable
executive: executive
extract: extract extracted
factor: factor
faculty: faculty
far: far
federal: federal
figure: figure
file: file
first: first
five: five
fix: fixed
flame: flame
flood: flooding
flora: flora
fluvioglacial: fluvioglacial
follow: follow following
forest: forest
form: form forming
foul: fouling
found: found
foundation: foundation
free: free
freeze: freezing
frequent: frequent
frequently: frequently
functional: functional
fungal: fungal
fungi: fungi
general: general
genesis: genesis
genus: genera genus
geochemical: geochemical
geochemistry: geochemistry
geographical: geographical
geography: geography
give: given
glass: glasses
grass: grass
grateful: grateful
great: great
green: green
group: group grouping
grown: grown
guideline: guideline
habitat: habitat
hanna: hanna
hazard: hazard
hazardous: hazardous
health: health
heavy: heavy
help: help
hence: hence
herbaceous: herbaceous
heterogeneity: heterogeneity
high: high higher highest
highly: highly
history: history
home: home
however: however
hygiene: hygiene
hygienic: hygienic
ice: ice
identification: identification
impact: impact
importance: importance
include: include included
index: index indexing
indicate: indicate
indicator: indicator
industrial: industrial
influence: influence
inhabit: inhabit
initial: initial
inland: inland
input: input
institute: institute
instrument: instrument
intensity: intensity
interest: interest
international: international
interurban: interurban
introduction: introduction
invertebrate: invertebrate
ion: ion
ionization: ionization
issue: issue
journal: journal
know: known
ko: ko
la: la
labile: labile
landscape: landscape
late: late
later: later
latter: latter
layer: layer
least: least
level: level
library: library
license: license licensed
line: line
liquid: liquid
literature: literature
little: little
load: load
location: location
login: login
low: low lower
magnification: magnification
main: main
mainly: mainly
make: make
manifest: manifested
manuscript: manuscript
maple: maple
marina: marina
maximum: maximum
may: may
mean: mean
medium: medium
menu: menu
metal: metal
method: method
mi: mi
microbial: microbial
microbiological: microbiological
microbiota: microbiota
microfauna: microfauna
microscopic: microscopic
mineral: mineral
mobile: mobile
moderately: moderately
modern: modern
modification: modification
moment: moment
monograph: monograph
month: month
moraine: moraine
morphology: morphology
motor: motor
mycelium: mycelium
mycological: mycological
natural: natural
nature: nature
near: near
necessary: necessary
neutral: neutral
new: new
news: news
ni: ni
nitrogen: nitrogen
normative: normative
northeastern: northeastern
northwestern: northwestern
note: noted
number: number
observation: observation
often: often
one: one
ontogenesis: ontogenesis
open: open
paper: paper
park: park
part: part
percentage: percentage
period: period
permanent: permanent
permissible: permissible
phototropic: phototropic
physical: physical
physicochemical: physicochemical
phytologist: phytologist
pine: pine
plain: plain
plant: plant
plate: plate
plot: plotting
podzolic: podzolic
policy: policy
pollution: pollution
possible: possible
power: power
practice: practice
precipitation: precipitation
predominant: predominant
preparation: preparation
presence: presence
preservation: preservation
prevail: prevail
prevalent: prevalent
primarily: primarily
priority: priority
privacy: privacy
project: project
proofread: proofreading
proportion: proportion
provide: provide
pst: pst
psych: psych
publication: publication
quality: quality
quite: quite
ra: ras
rail: rail
rare: rare
ratio: ratio
reaction: reaction
receive: receive
recommend: recommend
recreation: recreation
reflect: reflect
region: region
regression: regression
related: related
relation: relation
relative: relative
relatively: relatively
reliably: reliably
remains: remains
remediation: remediation
reorganization: reorganization
represent: represent
research: research
reserve: reserve reserved
residential: residential
resistant: resistant
respectively: respectively
respond: respond
response: response
responsive: responsive
resultant: resultant
retention: retention
retraction: retraction
reveal: reveal
river: river
road: road
rock: rock
role: role
russia: russia
salt: salt
sample: sampling
sanitary: sanitary
sar: sar
scale: scale
school: school
science: science
scientific: scientific
scope: scope
seasonal: seasonal
second: second
select: select selected
sequence: sequence
sequential: sequential
series: series
service: service
set: set
several: several
share: share
show: show
significance: significance
significant: significant
significantly: significantly
similar: similar
similarity: similarity
single: single
size: size
slightly: slightly
small: small smaller
snow: snow
society: society
sodium: sodium
soft: soft
soil: soil
soluble: soluble
solution: solution
southern: southern
sown: sown
spatial: spatial
special: special
specie: species
specific: specific
spectrometer: spectrometer
spectrophotometer: spectrophotometer
spectroscopy: spectroscopy
spring: spring
springer: springer
state: state
statement: statement
statistical: statistical
status: status
sterile: sterile
still: still
strong: strong
structure: structure
studio: studio
study: studied study
subject: subject
submit: submit
subscription: subscription
subzone: subzone
suggest: suggest
suitability: suitability
sum: sum
summer: summer
surface: surface
syllabus: syllabus
system: system
systematization: systematization
table: table
taiga: taiga
take: taken
taxonomy: taxonomy
temperature: temperature
terrestrial: terrestrial
test: test
theory: theory
thermal: thermal
thesis: theses
thus: thus
ti: ti
time: time times
top: top
total: total
totality: totality
traffic: traffic
transformation: transformation
translation: translation
transport: transport
treatment: treatment
tree: tree
two: two
typical: typical
understood: understood
undisturbed: undisturbed
university: university
upland: upland
upon: upon
urban: urban
us: us
use: use used
valley: valley
value: value
van: van
variability: variability
variation: variation
various: various
vary: vary
vegetation: vegetation
view: view
virgin: virgin
vol: vol
volume: volume
warm: warm
waste: waste
water: water
weakly: weakly
well: well
wet: wet wetted
whose: whose
winter: winter
within: within
work: work works
yellow: yellow
ym: ym
york: york
zinc: zinc
zo: zo
zonal: zonal
zone: zone
