aa: aa
abb: abb
ability: ability
absorber: absorber
abstract: abstract
abundant: abundant
accelerator: accelerator
acceptable: acceptable
access: access
accord: according
account: account
accurate: accurate
across: across
act: act
active: active
actual: actual
ad: ad
add: add added
addition: addition
address: address
advance: advance
advantage: advantage
ae: ae
aer: aer
affect: affect
affected: affected
afterwards: afterwards
agate: agate
aid: aid
aim: aim
air: air
ait: ait
al: al
alert: alert
also: also
aluminum: aluminum
aly: aly
ami: ami
amount: amount
analysis: analysis
angle: angle
anisotropy: anisotropy
anomalous: anomalous
another: another
ape: ape
apply: applied
approximate: approximate
archive: archive
around: around
article: article
atomic: atomic
attribution: attribution
author: author
average: average
avoid: avoid
ba: ba
background: background
base: based
beam: beam
begin: beginning
behave: behave
behavior: behavior
belonging: belonging
best: best
board: board
break: breaking
bulk: bulk
calcium: calcium
calculate: calculated
cancel: cancel
carbon: carbon
cause: causing
ce: ce
cell: cell
center: center
ceramic: ceramic
chamber: chamber
charge: charge
chemical: chemical
chemistry: chemistry
cho: cho
cite: cite
clear: clear
clearly: clearly
close: close closed
closer: closer
coat: coated
cobalt: cobalt
coefficient: coefficient
coherence: coherence
combine: combined combining
commission: commission
common: commons
complementary: complementary
compose: compose
composition: composition
conclusion: conclusion
condense: condensed
conduction: conduction
conductive: conductive
conductivity: conductivity
conductor: conductor
confirm: confirming
consequently: consequently
consistent: consistent
constant: constant
contact: contact
contamination: contamination
content: content contents
continuous: continuous
contribution: contribution
control: control
controller: controller
conventional: conventional
cooper: cooper
copper: copper
copyright: copyright
correspond: corresponding
could: could
couple: coupling
creative: creative
crest: crest
criterion: criterion
critical: critical
cross: cross
crush: crushed
cryogenic: cryogenic
crystal: crystal
crystalline: crystalline
current: current
curvature: curvature
curve: curve
customer: customer
data: data
declare: declare
decrease: decrease
delamination: delamination
deliver: deliver
density: density
deoxygenation: deoxygenation
department: department
dependence: dependence
dependent: dependent
depth: depth
derive: derived
destroy: destroy
destruction: destruction
detection: detection
detector: detector
deteriorate: deteriorate
deterioration: deterioration
determination: determination
determine: determine determined
development: development
deviation: deviation
diameter: diameter
different: different
diffraction: diffraction
diffractometer: diffractometer
diffusion: diffusion
digital: digital
dimensional: dimensional
disc: disc
disclaimer: disclaimer
disorder: disorder
distribution: distribution
drop: drop
due: due
editorial: editorial
effect: effect effects
effective: effective
el: el
elastic: elastic
elasticity: elasticity
electric: electric
electrical: electrical
electron: electron
element: element
elemental: elemental
eliminate: eliminate
emission: emission
energy: energy
enhance: enhanced
enhancement: enhancement
ensure: ensure
enter: enter
equation: equation
er: er
erbium: erbium
error: error
especially: especially
essential: essential
ethic: ethics
eu: eu
excess: excess
excessive: excessive
excitation: excitation
experimental: experimental
explanation: explanation
extent: extent
fabrication: fabrication
facility: facility
fact: fact
faculty: faculty
family: family
fe: fe
ferrite: ferrite
ferromagnetic: ferromagnetic
ferromagnetism: ferromagnetism
field: field
figure: figure
file: file
fill: filled
filter: filter
final: final
first: first
fit: fit fitted
fitting: fitting
flow: flow
flux: flux
follow: follow following
form: form formed
formation: formation
found: found
four: four
fraction: fraction
free: free
frequently: frequently
front: front
fundamental: fundamental
furthermore: furthermore
gas: gas
get: get
give: given
grain: grain
great: greater
ground: ground
group: group
grown: grown
growth: growth
guan: guan
guide: guide
guideline: guideline
hand: hand
health: health
heating: heating
helium: helium
hence: hence
high: high higher
highly: highly
history: history
home: home
homogeneity: homogeneity
homogeneous: homogeneous
homogenous: homogenous
host: host
hour: hour
however: however
iba: iba
immersion: immersion
important: important
improve: improving
improvement: improvement
impurity: impurity
inaccurate: inaccurate
incident: incident
increase: increase increasing
index: indexing
indexed: indexed
indicate: indicate
indication: indication
indicator: indicator
indirect: indirect
induced: induced
influence: influence
inside: inside
insignificant: insignificant
inspect: inspect
insulator: insulator
intensity: intensity
interaction: interaction
interest: interest
interface: interface
intergranular: intergranular
international: international
introduction: introduction
invariance: invariance
investigate: investigate
investigation: investigation
ion: ion
irradiation: irradiation
irreversibility: irreversibility
issue: issue
journal: journal
junction: junction
kept: kept
khan: khan
khatib: khatib
know: known
lab: lab
laboratory: laboratory
large: large
lattice: lattice
layer: layer
lead: leading
leakage: leakage
lee: lee
lei: lei
length: length
li: li
library: library
license: license licensed
like: like
likely: likely
line: line
liquid: liquid
list: listed
login: login
longitudinal: longitudinal
low: low lower
magnetic: magnetic
magnetism: magnetism
main: main
make: made
manuscript: manuscript
many: many
mass: mass
material: material
matrix: matrix
matter: matter
may: may
measure: measured measuring
mechanical: mechanical
medium: medium
menu: menu
metal: metal
method: method
mi: mi
microscope: microscope
microscopic: microscopic
microstructure: microstructure
mixed: mixed
mixture: mixture
mobile: mobile
model: model
molecular: molecular
moreover: moreover
morphology: morphology
mortar: mortar
motion: motion
movement: movement
much: much
muller: muller
na: na
natural: natural
nature: nature
nearly: nearly
news: news
nitrogen: nitrogen
nominal: nominal
normal: normal
novel: novel
nuclear: nuclear
number: number
observation: observation
obtain: obtain
obvious: obvious
occur: occur
one: one
open: open
opening: opening
optimal: optimal
optimum: optimum
order: order
orthorhombic: orthorhombic
overcome: overcome
oxygen: oxygen
paint: paint
paper: paper
partially: partially
particle: particle
passivity: passivity
pattern: pattern
peak: peak
pellet: pellet
penetration: penetration
per: per
percentage: percentage
phase: phase phases
physic: physics
physical: physical
pin: pinned pinning
planar: planar
point: point
policy: policy
polycrystalline: polycrystalline
pore: pore
porosity: porosity
porous: porous
possible: possible
potential: potential
powder: powder
power: power
practically: practically
precision: precision
preparation: preparation
prepared: prepared
presence: presence
present: present
preservation: preservation
prevent: prevent
previous: previous
principle: principle
privacy: privacy
probable: probable
probably: probably
probe: probe
problem: problem
process: process
production: production
progressive: progressive
promising: promising
proofread: proofreading
proton: proton
pst: pst
psych: psych
publication: publication
pure: pure
purity: purity
quality: quality
radiation: radiation
range: range
rapid: rapid
rate: rate
ratio: ratio
ray: ray
reaction: reaction
real: real
reason: reason
receive: receive
recommend: recommend
reddy: reddy
reduce: reduced
reduction: reduction
refrigeration: refrigeration
related: related
relative: relative
relaxation: relaxation
remain: remain
remains: remains
report: report
represent: represent
research: research
reserve: reserved
residual: residual
resistance: resistance
resistivity: resistivity
resolution: resolution
respect: respect
respectively: respectively
rest: rest
result: result resulting
resultant: resultant
retardation: retardation
retraction: retraction
reverse: reverse
review: review
role: role
room: room
ruthenium: ruthenium
sample: sample
sar: sar
scan: scanning
scatter: scattering
science: science
scientific: scientific
scope: scope
secondary: secondary
section: section
see: seen
select: select
sensitive: sensitive
separation: separation
service: service
several: several
shama: shama
shape: shape
share: share
show: show shown
side: side
sieve: sieve
sift: sifted
significant: significant
silicon: silicon
silver: silver
similar: similar
simultaneously: simultaneously
since: since
single: single
sit: sit
size: size
slightly: slightly
small: small
soft: soft
solid: solid
solution: solution
solvent: solvent
space: space
spatial: spatial
special: special
spectroscopy: spectroscopy
spectrum: spectra spectrum
spin: spin
start: starting
state: state
statement: statement
statistical: statistical
still: still
stoichiometric: stoichiometric
stoichiometry: stoichiometry
strong: strong
strongly: strongly
structure: structure
study: study
subject: subject subjected
submit: submit
subscription: subscription
subsequently: subsequently
substitute: substituted
substitution: substitution
successfully: successfully
superconductive: superconductive
superconductivity: superconductivity
superconductor: superconductor
superposition: superposition
suppression: suppression
surprising: surprising
susceptibility: susceptibility
system: system
systematic: systematic
table: table
take: taken taking
tandem: tandem
target: target
technique: technique
technology: technology
temperature: temperature
theoretical: theoretical
theory: theory
therefore: therefore
thermocouple: thermocouple
thick: thick
thickness: thickness
ti: ti
toluene: toluene
top: top
total: total
transient: transient
transition: transition
translation: translation
transport: transport
trap: trap trapping
turn: turn
twin: twin
type: type
typical: typical
unit: unit
university: university
unsuspected: unsuspected
us: us
use: used
useful: useful
user: user
vacuum: vacuum
value: value
variation: variation
varied: varied
variety: variety
verify: verify
versus: versus
via: via
viscosity: viscosity
voltage: voltage
volume: volume
vortex: vortex vortices
wang: wang
way: way
weight: weight
well: well
wet: wet
whereas: whereas
white: white
whole: whole
wide: wide
within: within
work: work working
would: would
ym: ym
zero: zero
