aa: aa
abb: abb
abstract: abstract
abundance: abundance
academic: academic
access: access
accord: according
accumulation: accumulation
acetonitrile: acetonitrile
acid: acid
act: act
ad: ad
add: add
addition: addition
additionally: additionally
address: address
adult: adult
ae: ae
aer: aer
affect: affecting
agency: agency
agricultural: agricultural
agriculture: agriculture
aid: aid
aim: aim
air: air
ait: ait
al: al
alert: alert
also: also
alternate: alternate
although: although
altiplano: altiplano
altitude: altitude
ame: ame
ami: ami
among: among
analysis: analysis
analytical: analytical
analyze: analyze
animal: animal
annual: annual
antibiotic: antibiotic
ape: ape
arable: arable
archive: archive
aromatic: aromatic
around: around
article: article
aspergillus: aspergillus
attribution: attribution
author: author
average: average
base: based
biochemistry: biochemistry
biological: biological
biology: biology
blanco: blanco
blight: blight
blue: blue
board: board
book: book
breeding: breeding
briefly: briefly
bulletin: bulletin
calculate: calculated
cancer: cancer
carcinogenic: carcinogenic
carry: carried
ce: ce
centrifugation: centrifugation
cereal: cereal
certain: certain
chain: chain
chamber: chamber
chemical: chemical
chemically: chemically
chosen: chosen
chromatographic: chromatographic
chromatography: chromatography
chronic: chronic
cite: cite
city: city
classify: classified
clean: clean
clear: clear
climate: climate
collect: collected
collection: collection
colonization: colonization
color: color colors
colorant: colorant
column: column
combine: combined
commercial: commercial
commission: commission
common: common commons
company: company
compose: composed
comprise: comprised
concentration: concentration
conclusion: conclusion
consecutive: consecutive
consume: consume
consumption: consumption
contact: contact
contamination: contamination
content: content
contrary: contrary
contribution: contribution
control: control
copyright: copyright
corn: corn
correspond: corresponding
cotty: cotty
could: could
country: country
couple: coupled
creative: creative
cultivation: cultivation
customer: customer
da: das
dairy: dairy
data: data
de: de
declare: declare
define: defined
degradation: degradation
derivative: derivative
design: designed
despite: despite
detection: detection
detector: detector
determination: determination
determine: determine
dietary: dietary
different: different
directly: directly
disclaimer: disclaimer
discussion: discussion
disease: disease
distribution: distribution
diverse: diverse
dorn: dorn
dry: dried
dryness: dryness
due: due
earthworm: earthworm
ecology: ecology
edition: edition
editorial: editorial
effect: effect effects
eight: eight
el: el
eluate: eluate
emission: emission
en: en
enough: enough
environment: environment
environmental: environmental
equipment: equipment
especially: especially
essential: essential
estado: estado
estimation: estimation
ether: ether
ethic: ethics
ethyl: ethyl
eu: eu
evaluation: evaluation
evidence: evidence
excitation: excitation
experimental: experimental
exposure: exposure
extract: extracted
extraction: extraction
faculty: faculty
failure: failure
fed: fed
feed: feed feeding
figure: figure
file: file
filtration: filtration
final: final
finally: finally
find: find
first: first
five: five
flask: flask
flores: flores
flow: flow
fluorescence: fluorescence
follow: follow
food: food
found: found
free: free
frequently: frequently
fungal: fungal
fungi: fungi
fungicidal: fungicidal
fungus: fungus
general: general
geographically: geographically
give: give
good: good
grade: grade
grain: grain
grano: grano
grape: grape
grass: grass
green: green
ground: ground
group: group
grow: growing
growth: growth
guidance: guidance
guideline: guideline
hamster: hamster
hand: hand
harvest: harvest
head: head
health: health
heterocyclic: heterocyclic
hexane: hexane
high: high higher highest
history: history
home: home
hope: hope
host: host
however: however
human: human
humid: humid
hybrid: hybrid
identification: identification
impact: impact
important: important
improve: improve
incidence: incidence
indeed: indeed
index: indexing
indicate: indicate
industry: industry
infection: infection
infectious: infectious
influence: influence
information: information
injection: injection
inoculum: inoculum
instrument: instrument
intensive: intensive
interaction: interaction
interest: interest
interference: interference
international: international
introduction: introduction
investigate: investigate
ionization: ionization
isolate: isolate
isolation: isolation
issue: issue
journal: journal
know: know known
la: la
laboratory: laboratory
latitude: latitude
lee: lee
legal: legal
legislation: legislation
level: level
library: library
license: license licensed
like: like
liquid: liquid
little: little
login: login
longitude: longitude
loss: loss
low: low lower
maize: maize
make: made make making
management: management
manuscript: manuscript
martel: martel
mass: mass
material: material
maximum: maximum
may: may
mean: mean
median: median
medicine: medicine
menu: menu
method: method
methyl: methyl
mi: mi
microbiology: microbiology
might: might
milk: milk
milling: milling
min: min
minimum: minimum
mixed: mixed
mobile: mobile
monomethyl: monomethyl
multiple: multiple
national: national
natural: natural
naturally: naturally
need: need
neo: neo
nevertheless: nevertheless
news: news
norma: norma
north: north
note: noted
notify: notified
nutrition: nutrition
occurrence: occurrence
official: official
one: one
open: open
opinion: opinion
order: order
panel: panel
paper: paper
para: para
park: park
pathogen: pathogen
pathology: pathology
people: people
performance: performance
pharmacy: pharmacy
phase: phase
phytopathogenic: phytopathogenic
pink: pink
plant: plant planting
policy: policy
possible: possible
precursor: precursor
prepared: prepared
presence: presence
present: present
preservation: preservation
press: press
prevalence: prevalence
prevent: prevent
previously: previously
prior: prior
privacy: privacy
probably: probably
procedure: procedure
produce: produced
producer: producer
production: production
proofread: proofreading
protect: protect protecting
protein: protein
protocol: protocol
pst: pst
psych: psych
public: public
publication: publication
purification: purification
quadruple: quadruple
quality: quality
quantification: quantification
quantify: quantify
rainfall: rainfall
range: ranged ranging
rate: rate
raw: raw
receive: receive
recently: recently
recommend: recommend
redissolution: redissolution
region: region
regular: regular
regulate: regulated
regulation: regulation
related: related
remain: remain
remove: removed
repeat: repeated
request: request
research: research
reserve: reserved
residue: residue
respectively: respectively
retention: retention
retraction: retraction
reverse: reversed
rotation: rotation
rural: rural
safe: safe
sample: sample
sanitary: sanitary
saprophyte: saprophyte
sar: sar
science: science
scientific: scientific
scope: scope
screen: screening
secondary: secondary
section: section
seed: seed
seedling: seedling
select: select selected
senescent: senescent
series: series
serious: serious
service: service
set: setting
shaken: shaken
shaker: shaker
share: share
show: show
significance: significance
significant: significant
silage: silage
similar: similar
since: since
soft: soft
soil: soil
sow: sowing
soy: soy
soya: soya
special: special
specie: species
spectrometer: spectrometer
spring: spring
st: st
stability: stability
standard: standard
state: state
statement: statement
station: station
step: step
stock: stock
straw: straw
study: studied study
subject: subject
submit: submit
subscription: subscription
subspecies: subspecies
suggest: suggesting
survey: survey
survival: survival
susceptibility: susceptibility
susceptible: susceptible
symposium: symposium
synthetic: synthetic
system: system
table: table
take: taken
tandem: tandem
technology: technology
temperate: temperate
three: three
ti: ti
time: time
top: top
tortilla: tortilla
total: total
toxic: toxic
toxicology: toxicology
toxin: toxin
trace: trace
translation: translation
transmission: transmission
treatment: treatment
trilinear: trilinear
tropical: tropical
twelve: twelve
two: two
type: type
ubiquitous: ubiquitous
um: um
union: union
university: university
us: us
use: used
useful: useful
value: value
van: van
variety: variety
various: various
vertical: vertical
veterinary: veterinary
vineyard: vineyard
volume: volume
volumetric: volumetric
warehouse: warehouse
warm: warm
water: water
weight: weighting
well: well
west: west
wet: wet
wheat: wheat
white: white
within: within
work: work working
world: world
would: would
xi: xi
yellow: yellow
ym: ym
za: za
